Year,Season,Nation,NOC Code,Gold,Silver,Bronze,Total
2008,Summer,Afghanistan,AFG,0,0,1,1
2012,Summer,Afghanistan,AFG,0,0,1,1
1984,Summer,Algeria,ALG,0,0,2,2
1992,Summer,Algeria,ALG,1,0,1,2
1996,Summer,Algeria,ALG,2,0,1,3
2000,Summer,Algeria,ALG,1,1,3,5
2008,Summer,Algeria,ALG,0,1,1,2
2012,Summer,Algeria,ALG,1,0,0,1
2016,Summer,Algeria,ALG,0,2,0,2
1964,Summer,Argentina,ARG,0,1,0,1
1968,Summer,Argentina,ARG,0,0,2,2
1972,Summer,Argentina,ARG,0,1,0,1
1988,Summer,Argentina,ARG,0,1,1,2
1992,Summer,Argentina,ARG,0,0,1,1
1996,Summer,Argentina,ARG,0,2,1,3
2000,Summer,Argentina,ARG,0,2,2,4
2004,Summer,Argentina,ARG,2,0,4,6
2008,Summer,Argentina,ARG,2,0,4,6
2012,Summer,Argentina,ARG,1,1,2,4
2016,Summer,Argentina,ARG,3,1,0,4
1960,Summer,Argentina,ARG,0,1,1,2
2020-21,Summer,Argentina,ARG,0,1,2,3
1996,Summer,Armenia,ARM,1,1,0,2
2000,Summer,Armenia,ARM,0,0,1,1
2008,Summer,Armenia,ARM,0,1,4,5
2012,Summer,Armenia,ARM,0,1,1,2
2016,Summer,Armenia,ARM,1,3,0,4
2020-21,Summer,Armenia,ARM,0,2,2,4
1964,Summer,Australia,AUS,6,2,10,18
1968,Summer,Australia,AUS,5,7,5,17
1972,Summer,Australia,AUS,8,7,2,17
1976,Summer,Australia,AUS,0,1,4,5
1980,Summer,Australia,AUS,2,2,5,9
1984,Summer,Australia,AUS,4,8,12,24
1988,Summer,Australia,AUS,3,6,5,14
1992,Summer,Australia,AUS,7,9,11,27
1996,Summer,Australia,AUS,9,9,23,41
2004,Summer,Australia,AUS,17,16,17,50
2008,Summer,Australia,AUS,14,15,17,46
2012,Summer,Australia,AUS,8,15,12,35
2016,Summer,Australia,AUS,8,11,10,29
1960,Summer,Australia,AUS,8,8,6,22
2020-21,Summer,Australia,AUS,17,7,22,46
2000,Summer,Australia*,AUS,16,25,17,58
1968,Summer,Austria,AUT,0,2,2,4
1972,Summer,Austria,AUT,0,1,2,3
1976,Summer,Austria,AUT,0,0,1,1
1980,Summer,Austria,AUT,1,2,1,4
1984,Summer,Austria,AUT,1,1,1,3
1988,Summer,Austria,AUT,1,0,0,1
1992,Summer,Austria,AUT,0,2,0,2
1996,Summer,Austria,AUT,0,1,2,3
2000,Summer,Austria,AUT,2,1,0,3
2004,Summer,Austria,AUT,2,4,1,7
2008,Summer,Austria,AUT,0,1,2,3
2016,Summer,Austria,AUT,0,0,1,1
1960,Summer,Austria,AUT,1,1,0,2
2020-21,Summer,Austria,AUT,1,1,5,7
1996,Summer,Azerbaijan,AZE,0,1,0,1
2000,Summer,Azerbaijan,AZE,2,0,1,3
2004,Summer,Azerbaijan,AZE,1,0,4,5
2008,Summer,Azerbaijan,AZE,1,1,4,6
2012,Summer,Azerbaijan,AZE,2,2,5,9
2016,Summer,Azerbaijan,AZE,1,7,10,18
2020-21,Summer,Azerbaijan,AZE,0,3,4,7
1964,Summer,Bahamas,BAH,1,0,0,1
1992,Summer,Bahamas,BAH,0,0,1,1
1996,Summer,Bahamas,BAH,0,1,0,1
2000,Summer,Bahamas,BAH,2,0,1,3
2004,Summer,Bahamas,BAH,1,0,1,2
2008,Summer,Bahamas,BAH,0,1,1,2
2012,Summer,Bahamas,BAH,1,0,0,1
2016,Summer,Bahamas,BAH,1,0,1,2
2020-21,Summer,Bahamas,BAH,2,0,0,2
2012,Summer,Bahrain,BRN,1,0,0,1
2016,Summer,Bahrain,BRN,1,1,0,2
2020-21,Summer,Bahrain,BRN,0,1,0,1
2000,Summer,Barbados,BAR,0,0,1,1
1996,Summer,Belarus,BLR,1,6,8,15
2000,Summer,Belarus,BLR,3,3,11,17
2004,Summer,Belarus,BLR,2,5,6,13
2008,Summer,Belarus,BLR,3,4,7,14
2012,Summer,Belarus,BLR,2,5,3,10
2016,Summer,Belarus,BLR,1,4,4,9
2020-21,Summer,Belarus,BLR,1,3,3,7
1964,Summer,Belgium,BEL,2,0,1,3
1968,Summer,Belgium,BEL,0,1,1,2
1972,Summer,Belgium,BEL,0,2,0,2
1976,Summer,Belgium,BEL,0,3,3,6
1980,Summer,Belgium,BEL,1,0,0,1
1984,Summer,Belgium,BEL,1,1,2,4
1988,Summer,Belgium,BEL,0,0,2,2
1992,Summer,Belgium,BEL,0,1,2,3
1996,Summer,Belgium,BEL,2,2,2,6
2000,Summer,Belgium,BEL,0,2,3,5
2004,Summer,Belgium,BEL,1,0,2,3
2008,Summer,Belgium,BEL,2,0,0,2
2012,Summer,Belgium,BEL,0,1,2,3
2016,Summer,Belgium,BEL,2,2,2,6
1960,Summer,Belgium,BEL,0,2,2,4
2020-21,Summer,Belgium,BEL,3,1,3,7
1976,Summer,Bermuda,BER,0,0,1,1
2020-21,Summer,Bermuda,BER,1,0,0,1
2012,Summer,Botswana,BOT,0,1,0,1
2020-21,Summer,Botswana,BOT,0,0,1,1
1964,Summer,Brazil,BRA,0,0,1,1
1968,Summer,Brazil,BRA,0,1,2,3
1972,Summer,Brazil,BRA,0,0,2,2
1976,Summer,Brazil,BRA,0,0,2,2
1980,Summer,Brazil,BRA,2,0,2,4
1984,Summer,Brazil,BRA,1,5,2,8
1988,Summer,Brazil,BRA,1,2,3,6
1992,Summer,Brazil,BRA,2,1,0,3
1996,Summer,Brazil,BRA,3,3,9,15
2000,Summer,Brazil,BRA,0,6,6,12
2004,Summer,Brazil,BRA,5,2,3,10
2008,Summer,Brazil,BRA,3,4,10,17
2012,Summer,Brazil,BRA,3,5,9,17
1960,Summer,Brazil,BRA,0,0,2,2
2020-21,Summer,Brazil,BRA,7,6,8,21
2016,Summer,Brazil,BRA,7,6,6,19
1960,Summer,British West Indies ,BWI,0,0,2,2
1964,Summer,Bulgaria,BUL,3,5,2,10
1968,Summer,Bulgaria,BUL,2,4,3,9
1972,Summer,Bulgaria,BUL,6,10,5,21
1976,Summer,Bulgaria,BUL,6,9,7,22
1980,Summer,Bulgaria,BUL,8,16,17,41
1988,Summer,Bulgaria,BUL,10,12,13,35
1992,Summer,Bulgaria,BUL,3,7,6,16
1996,Summer,Bulgaria,BUL,3,7,5,15
2000,Summer,Bulgaria,BUL,5,6,2,13
2004,Summer,Bulgaria,BUL,2,1,9,12
2008,Summer,Bulgaria,BUL,1,1,3,5
2012,Summer,Bulgaria,BUL,0,2,1,3
2016,Summer,Bulgaria,BUL,0,1,2,3
1960,Summer,Bulgaria,BUL,1,3,3,7
2020-21,Summer,Bulgaria,BUL,3,1,2,6
2020-21,Summer,Burkina Faso ,BUR,0,0,1,1
1996,Summer,Burundi,BDI,1,0,0,1
2016,Summer,Burundi,BDI,0,1,0,1
1968,Summer,Cameroon,CMR,0,1,0,1
1984,Summer,Cameroon,CMR,0,0,1,1
2000,Summer,Cameroon,CMR,1,0,0,1
2004,Summer,Cameroon,CMR,1,0,0,1
2008,Summer,Cameroon,CMR,1,0,0,1
2012,Summer,Cameroon,CMR,0,0,1,1
1964,Summer,Canada,CAN,1,2,1,4
1968,Summer,Canada,CAN,1,3,1,5
1972,Summer,Canada,CAN,0,2,3,5
1984,Summer,Canada,CAN,10,18,16,44
1988,Summer,Canada,CAN,3,2,5,10
1992,Summer,Canada,CAN,7,4,7,18
1996,Summer,Canada,CAN,3,11,8,22
2000,Summer,Canada,CAN,3,3,8,14
2004,Summer,Canada,CAN,3,6,3,12
2008,Summer,Canada,CAN,3,9,8,20
2012,Summer,Canada,CAN,2,6,10,18
2016,Summer,Canada,CAN,4,3,15,22
1960,Summer,Canada,CAN,0,1,0,1
2020-21,Summer,Canada,CAN,7,6,11,24
1976,Summer,Canada*,CAN,0,5,6,11
1988,Summer,Chile,CHI,0,1,0,1
2000,Summer,Chile,CHI,0,0,1,1
2004,Summer,Chile,CHI,2,0,1,3
2008,Summer,Chile,CHI,0,1,0,1
1984,Summer,China,CHN,15,8,9,32
1988,Summer,China,CHN,5,11,12,28
1992,Summer,China,CHN,16,22,16,54
1996,Summer,China,CHN,16,22,12,50
2000,Summer,China,CHN,28,16,14,58
2004,Summer,China,CHN,32,17,14,63
2012,Summer,China,CHN,38,31,22,91
2016,Summer,China,CHN,26,18,26,70
2020-21,Summer,China,CHN,38,32,18,88
2008,Summer,China*,CHN,48,22,30,100
1984,Summer,Chinese Taipei,TPE,0,0,1,1
1992,Summer,Chinese Taipei,TPE,0,1,0,1
1996,Summer,Chinese Taipei,TPE,0,1,0,1
2000,Summer,Chinese Taipei,TPE,0,1,4,5
2004,Summer,Chinese Taipei,TPE,2,2,1,5
2008,Summer,Chinese Taipei,TPE,1,1,2,4
2012,Summer,Chinese Taipei,TPE,1,0,1,2
2016,Summer,Chinese Taipei,TPE,1,0,2,3
2020-21,Summer,Chinese Taipei,TPE,2,4,6,12
1972,Summer,Colombia,COL,0,1,2,3
1984,Summer,Colombia,COL,0,1,0,1
1988,Summer,Colombia,COL,0,0,1,1
1992,Summer,Colombia,COL,0,0,1,1
2000,Summer,Colombia,COL,1,0,0,1
2004,Summer,Colombia,COL,0,0,2,2
2008,Summer,Colombia,COL,0,2,1,3
2012,Summer,Colombia,COL,1,3,5,9
2016,Summer,Colombia,COL,3,2,3,8
2020-21,Summer,Colombia,COL,0,4,1,5
1988,Summer,Costa Rica,CRC,0,1,0,1
1996,Summer,Costa Rica,CRC,1,0,0,1
2000,Summer,Costa Rica,CRC,0,0,2,2
1992,Summer,Croatia,CRO,0,1,2,3
1996,Summer,Croatia,CRO,1,1,0,2
2000,Summer,Croatia,CRO,1,0,1,2
2004,Summer,Croatia,CRO,1,2,2,5
2008,Summer,Croatia,CRO,0,2,3,5
2012,Summer,Croatia,CRO,3,1,2,6
2016,Summer,Croatia,CRO,5,3,2,10
2020-21,Summer,Croatia,CRO,3,3,2,8
1964,Summer,Cuba,CUB,0,1,0,1
1968,Summer,Cuba,CUB,0,4,0,4
1972,Summer,Cuba,CUB,3,1,4,8
1976,Summer,Cuba,CUB,6,4,3,13
1980,Summer,Cuba,CUB,8,7,5,20
1992,Summer,Cuba,CUB,14,6,11,31
1996,Summer,Cuba,CUB,9,8,8,25
2000,Summer,Cuba,CUB,11,11,7,29
2004,Summer,Cuba,CUB,9,7,11,27
2008,Summer,Cuba,CUB,3,10,17,30
2012,Summer,Cuba,CUB,5,3,7,15
2016,Summer,Cuba,CUB,5,2,4,11
2020-21,Summer,Cuba,CUB,7,3,5,15
2012,Summer,Cyprus,CYP,0,1,0,1
1996,Summer,Czech Republic,CZE,4,3,4,11
2000,Summer,Czech Republic,CZE,2,3,3,8
2004,Summer,Czech Republic,CZE,1,3,5,9
2008,Summer,Czech Republic,CZE,3,3,1,7
2012,Summer,Czech Republic,CZE,4,3,4,11
2016,Summer,Czech Republic,CZE,1,2,7,10
2020-21,Summer,Czech Republic ,CZE,4,4,3,11
1964,Summer,Czechoslovakia,TCH,5,6,3,14
1968,Summer,Czechoslovakia,TCH,7,2,4,13
1972,Summer,Czechoslovakia,TCH,2,4,2,8
1976,Summer,Czechoslovakia,TCH,2,2,4,8
1980,Summer,Czechoslovakia,TCH,2,3,9,14
1988,Summer,Czechoslovakia,TCH,3,3,2,8
1992,Summer,Czechoslovakia,TCH,4,2,1,7
1960,Summer,Czechoslovakia ,TCH,3,2,3,8
1964,Summer,Denmark,DEN,2,1,3,6
1968,Summer,Denmark,DEN,1,4,3,8
1972,Summer,Denmark,DEN,1,0,0,1
1976,Summer,Denmark,DEN,1,0,2,3
1980,Summer,Denmark,DEN,2,1,2,5
1984,Summer,Denmark,DEN,0,3,3,6
1988,Summer,Denmark,DEN,2,1,1,4
1992,Summer,Denmark,DEN,1,1,4,6
1996,Summer,Denmark,DEN,4,1,1,6
2000,Summer,Denmark,DEN,2,3,1,6
2004,Summer,Denmark,DEN,2,1,5,8
2008,Summer,Denmark,DEN,2,2,3,7
2012,Summer,Denmark,DEN,2,4,3,9
2016,Summer,Denmark,DEN,2,6,7,15
1960,Summer,Denmark,DEN,2,3,1,6
2020-21,Summer,Denmark,DEN,3,4,4,11
1988,Summer,Djibouti,DJI,0,0,1,1
1984,Summer,Dominican Republic,DOM,0,0,1,1
2004,Summer,Dominican Republic,DOM,1,0,0,1
2008,Summer,Dominican Republic,DOM,1,1,0,2
2012,Summer,Dominican Republic,DOM,1,1,0,2
2016,Summer,Dominican Republic,DOM,0,0,1,1
2020-21,Summer,Dominican Republic,DOM,0,3,2,5
1968,Summer,East Germany,GDR,9,9,7,25
1972,Summer,East Germany,GDR,20,23,23,66
1976,Summer,East Germany,GDR,40,25,25,90
1980,Summer,East Germany,GDR,47,37,42,126
1988,Summer,East Germany,GDR,37,35,30,102
1996,Summer,Ecuador,ECU,1,0,0,1
2008,Summer,Ecuador,ECU,0,1,0,1
2020-21,Summer,Ecuador,ECU,2,1,0,3
1984,Summer,Egypt,EGY,0,1,0,1
2004,Summer,Egypt,EGY,1,1,3,5
2008,Summer,Egypt,EGY,0,0,2,2
2012,Summer,Egypt,EGY,0,3,1,4
2016,Summer,Egypt,EGY,0,0,3,3
1960,Summer,Egypt,EGY,0,1,1,2
2020-21,Summer,Egypt,EGY,1,1,4,6
2004,Summer,Eritrea,ERI,0,0,1,1
1992,Summer,Estonia,EST,1,0,1,2
2000,Summer,Estonia,EST,1,0,2,3
2004,Summer,Estonia,EST,0,1,2,3
2008,Summer,Estonia,EST,1,1,0,2
2012,Summer,Estonia,EST,0,1,1,2
2016,Summer,Estonia,EST,0,0,1,1
2020-21,Summer,Estonia,EST,1,0,1,2
1964,Summer,Ethiopia,ETH,1,0,0,1
1968,Summer,Ethiopia,ETH,1,1,0,2
1972,Summer,Ethiopia,ETH,0,0,2,2
1980,Summer,Ethiopia,ETH,2,0,2,4
1992,Summer,Ethiopia,ETH,1,0,2,3
1996,Summer,Ethiopia,ETH,2,0,1,3
2000,Summer,Ethiopia,ETH,4,1,3,8
2004,Summer,Ethiopia,ETH,2,3,2,7
2008,Summer,Ethiopia,ETH,4,2,1,7
2012,Summer,Ethiopia,ETH,3,2,3,8
2016,Summer,Ethiopia,ETH,1,2,5,8
1960,Summer,Ethiopia,ETH,1,0,0,1
2020-21,Summer,Ethiopia,ETH,1,1,2,4
2016,Summer,Fiji,FIJ,1,0,0,1
2020-21,Summer,Fiji,FIJ,1,0,1,2
1964,Summer,Finland,FIN,3,0,2,5
1968,Summer,Finland,FIN,1,2,1,4
1972,Summer,Finland,FIN,3,1,4,8
1976,Summer,Finland,FIN,4,2,0,6
1980,Summer,Finland,FIN,3,1,4,8
1984,Summer,Finland,FIN,4,2,6,12
1988,Summer,Finland,FIN,1,1,2,4
1992,Summer,Finland,FIN,1,2,2,5
1996,Summer,Finland,FIN,1,2,1,4
2000,Summer,Finland,FIN,2,1,1,4
2004,Summer,Finland,FIN,0,2,0,2
2008,Summer,Finland,FIN,1,1,2,4
2012,Summer,Finland,FIN,0,2,1,3
2016,Summer,Finland,FIN,0,0,1,1
1960,Summer,Finland,FIN,1,1,3,5
2020-21,Summer,Finland,FIN,0,0,2,2
1960,Summer,Formosa ,RCF,0,1,0,1
1996,Summer,Yugoslavia,YUG,1,1,2,4
2000,Summer,Yugoslavia,YUG,1,1,1,3
1964,Summer,France,FRA,1,8,6,15
1968,Summer,France,FRA,7,3,5,15
1972,Summer,France,FRA,2,4,7,13
1976,Summer,France,FRA,2,3,4,9
1980,Summer,France,FRA,6,5,3,14
1984,Summer,France,FRA,5,7,16,28
1988,Summer,France,FRA,6,4,6,16
1992,Summer,France,FRA,8,5,16,29
1996,Summer,France,FRA,15,7,15,37
2000,Summer,France,FRA,13,14,11,38
2004,Summer,France,FRA,11,9,13,33
2008,Summer,France,FRA,7,16,20,43
2012,Summer,France,FRA,11,11,13,35
2016,Summer,France,FRA,10,18,14,42
1960,Summer,France,FRA,0,2,3,5
2020-21,Summer,France,FRA,10,12,11,33
2012,Summer,Gabon,GAB,0,1,0,1
1996,Summer,Georgia,GEO,0,0,2,2
2000,Summer,Georgia,GEO,0,0,6,6
2004,Summer,Georgia,GEO,2,2,0,4
2008,Summer,Georgia,GEO,3,2,2,7
2012,Summer,Georgia,GEO,1,2,3,6
2016,Summer,Georgia,GEO,2,1,4,7
2020-21,Summer,Georgia ,GEO,2,5,1,8
1992,Summer,Germany,GER,33,21,28,82
1996,Summer,Germany,GER,20,18,27,65
2000,Summer,Germany,GER,13,17,26,56
2004,Summer,Germany,GER,13,16,20,49
2008,Summer,Germany,GER,16,11,14,41
2012,Summer,Germany,GER,11,20,13,44
2016,Summer,Germany,GER,17,10,15,42
2020-21,Summer,Germany,GER,10,11,16,37
1964,Summer,Ghana,GHA,0,0,1,1
1972,Summer,Ghana,GHA,0,0,1,1
1992,Summer,Ghana,GHA,0,0,1,1
1960,Summer,Ghana,GHA,0,1,0,1
2020-21,Summer,Ghana,GHA,0,0,1,1
1964,Summer,Great Britain,GBR,4,12,2,18
1968,Summer,Great Britain,GBR,5,5,3,13
1972,Summer,Great Britain,GBR,4,5,9,18
1976,Summer,Great Britain,GBR,3,5,5,13
1980,Summer,Great Britain,GBR,5,7,9,21
1984,Summer,Great Britain,GBR,5,11,21,37
1988,Summer,Great Britain,GBR,5,10,9,24
1992,Summer,Great Britain,GBR,5,3,12,20
1996,Summer,Great Britain,GBR,1,8,6,15
2000,Summer,Great Britain,GBR,11,10,7,28
2004,Summer,Great Britain,GBR,9,9,12,30
2008,Summer,Great Britain,GBR,19,13,19,51
2016,Summer,Great Britain,GBR,27,23,17,67
1960,Summer,Great Britain,GBR,2,6,12,20
2020-21,Summer,Great Britain,GBR,22,21,22,65
2012,Summer,Great Britain*,GBR,29,18,18,65
1968,Summer,Greece,GRE,0,0,1,1
1972,Summer,Greece,GRE,0,2,0,2
1980,Summer,Greece,GRE,1,0,2,3
1984,Summer,Greece,GRE,0,1,1,2
1988,Summer,Greece,GRE,0,0,1,1
1992,Summer,Greece,GRE,2,0,0,2
1996,Summer,Greece,GRE,4,4,0,8
2000,Summer,Greece,GRE,4,6,3,13
2008,Summer,Greece,GRE,0,2,1,3
2012,Summer,Greece,GRE,0,0,2,2
2016,Summer,Greece,GRE,3,1,2,6
1960,Summer,Greece,GRE,1,0,0,1
2020-21,Summer,Greece,GRE,2,1,1,4
2004,Summer,Greece*,GRE,6,6,4,16
2012,Summer,Grenada,GRN,1,0,0,1
2016,Summer,Grenada,GRN,0,1,0,1
2020-21,Summer,Grenada,GRN,0,0,1,1
2012,Summer,Guatemala,GUA,0,1,0,1
1980,Summer,Guyana,GUY,0,0,1,1
1996,Summer,Hong Kong,HKG,1,0,0,1
2004,Summer,Hong Kong,HKG,0,1,0,1
2012,Summer,Hong Kong,HKG,0,0,1,1
2020-21,Summer,Hong Kong ,HKG,1,2,3,6
1964,Summer,Hungary,HUN,10,7,5,22
1968,Summer,Hungary,HUN,10,10,12,32
1972,Summer,Hungary,HUN,6,13,16,35
1976,Summer,Hungary,HUN,4,5,13,22
1980,Summer,Hungary,HUN,7,10,15,32
1988,Summer,Hungary,HUN,11,6,6,23
1992,Summer,Hungary,HUN,11,12,7,30
1996,Summer,Hungary,HUN,7,4,10,21
2000,Summer,Hungary,HUN,8,6,3,17
2004,Summer,Hungary,HUN,8,6,3,17
2008,Summer,Hungary,HUN,3,5,2,10
2012,Summer,Hungary,HUN,8,4,6,18
2016,Summer,Hungary,HUN,8,3,4,15
1960,Summer,Hungary,HUN,6,8,7,21
2020-21,Summer,Hungary,HUN,6,7,7,20
1984,Summer,Iceland,ISL,0,0,1,1
2000,Summer,Iceland,ISL,0,0,1,1
2008,Summer,Iceland,ISL,0,1,0,1
2016,Summer,Independent Olympic Athletes,IOA,1,0,1,2
1992,Summer,Independent Olympic Participants,IOP,0,1,2,3
1964,Summer,India,IND,1,0,0,1
1968,Summer,India,IND,0,0,1,1
1972,Summer,India,IND,0,0,1,1
1980,Summer,India,IND,1,0,0,1
1996,Summer,India,IND,0,0,1,1
2000,Summer,India,IND,0,0,1,1
2004,Summer,India,IND,0,1,0,1
2008,Summer,India,IND,1,0,2,3
2012,Summer,India,IND,0,2,4,6
2016,Summer,India,IND,0,1,1,2
1960,Summer,India,IND,0,1,0,1
2020-21,Summer,India,IND,1,2,4,7
1988,Summer,Indonesia,INA,0,1,0,1
1992,Summer,Indonesia,INA,2,2,1,5
1996,Summer,Indonesia,INA,1,1,2,4
2000,Summer,Indonesia,INA,1,3,2,6
2004,Summer,Indonesia,INA,1,1,2,4
2008,Summer,Indonesia,INA,1,1,4,6
2012,Summer,Indonesia,INA,0,2,1,3
2016,Summer,Indonesia,INA,1,2,0,3
2020-21,Summer,Indonesia,INA,1,1,3,5
1964,Summer,Iran,IRI,0,0,2,2
1968,Summer,Iran,IRI,2,1,2,5
1972,Summer,Iran,IRI,0,2,1,3
1976,Summer,Iran,IRI,0,1,1,2
1988,Summer,Iran,IRI,0,1,0,1
1992,Summer,Iran,IRI,0,1,2,3
1996,Summer,Iran,IRI,1,1,1,3
2000,Summer,Iran,IRI,3,0,1,4
2004,Summer,Iran,IRI,2,2,2,6
2008,Summer,Iran,IRI,1,0,1,2
2012,Summer,Iran,IRI,7,5,1,13
2016,Summer,Iran,IRI,3,1,4,8
1960,Summer,Iran,IRI,0,1,3,4
2020-21,Summer,Iran,IRI,3,2,2,7
1960,Summer,Iraq ,IRQ,0,0,1,1
1964,Summer,Ireland,IRL,0,0,1,1
1980,Summer,Ireland,IRL,0,1,1,2
1984,Summer,Ireland,IRL,0,1,0,1
1992,Summer,Ireland,IRL,1,1,0,2
1996,Summer,Ireland,IRL,3,0,1,4
2000,Summer,Ireland,IRL,0,1,0,1
2008,Summer,Ireland,IRL,0,1,2,3
2012,Summer,Ireland,IRL,1,1,4,6
2016,Summer,Ireland,IRL,0,2,0,2
2020-21,Summer,Ireland,IRL,2,0,2,4
1992,Summer,Israel,ISR,0,1,1,2
1996,Summer,Israel,ISR,0,0,1,1
2000,Summer,Israel,ISR,0,0,1,1
2004,Summer,Israel,ISR,1,0,1,2
2008,Summer,Israel,ISR,0,0,1,1
2016,Summer,Israel,ISR,0,0,2,2
2020-21,Summer,Israel,ISR,2,0,2,4
1964,Summer,Italy,ITA,10,10,7,27
1968,Summer,Italy,ITA,3,4,9,16
1972,Summer,Italy,ITA,5,3,10,18
1976,Summer,Italy,ITA,2,7,4,13
1980,Summer,Italy,ITA,8,3,4,15
1984,Summer,Italy,ITA,14,6,12,32
1988,Summer,Italy,ITA,6,4,4,14
1992,Summer,Italy,ITA,6,5,8,19
1996,Summer,Italy,ITA,13,10,12,35
2000,Summer,Italy,ITA,13,8,13,34
2004,Summer,Italy,ITA,10,11,11,32
2008,Summer,Italy,ITA,8,9,10,27
2012,Summer,Italy,ITA,8,9,11,28
2016,Summer,Italy,ITA,8,12,8,28
1960,Summer,Italy,ITA,13,10,13,36
2020-21,Summer,Italy,ITA,10,10,20,40
1984,Summer,Ivory Coast,CIV,0,1,0,1
2016,Summer,Ivory Coast,CIV,1,0,1,2
2020-21,Summer,Ivory Coast,CIV,0,0,1,1
1968,Summer,Jamaica,JAM,0,1,0,1
1972,Summer,Jamaica,JAM,0,0,1,1
1976,Summer,Jamaica,JAM,1,1,0,2
1980,Summer,Jamaica,JAM,0,0,3,3
1984,Summer,Jamaica,JAM,0,1,2,3
1988,Summer,Jamaica,JAM,0,2,0,2
1992,Summer,Jamaica,JAM,0,3,1,4
1996,Summer,Jamaica,JAM,1,3,2,6
2000,Summer,Jamaica,JAM,0,6,3,9
2004,Summer,Jamaica,JAM,2,1,2,5
2008,Summer,Jamaica,JAM,5,4,2,11
2012,Summer,Jamaica,JAM,4,5,3,12
2016,Summer,Jamaica,JAM,6,3,2,11
2020-21,Summer,Jamaica,JAM,4,1,4,9
1968,Summer,Japan,JPN,11,7,7,25
1972,Summer,Japan,JPN,13,8,8,29
1976,Summer,Japan,JPN,9,6,10,25
1984,Summer,Japan,JPN,10,8,14,32
1988,Summer,Japan,JPN,4,3,7,14
1992,Summer,Japan,JPN,3,8,11,22
1996,Summer,Japan,JPN,3,6,5,14
2000,Summer,Japan,JPN,5,8,5,18
2004,Summer,Japan,JPN,16,9,12,37
2008,Summer,Japan,JPN,9,8,8,25
2012,Summer,Japan,JPN,7,14,17,38
2016,Summer,Japan,JPN,12,8,21,41
1960,Summer,Japan,JPN,4,7,7,18
2020-21,Summer,Japan,JPN,27,14,17,58
1964,Summer,Japan*,JPN,16,5,8,29
2016,Summer,Jordan,JOR,1,0,0,1
2020-21,Summer,Jordan,JOR,0,1,1,2
1996,Summer,Kazakhstan,KAZ,3,4,4,11
2000,Summer,Kazakhstan,KAZ,3,4,0,7
2004,Summer,Kazakhstan,KAZ,1,4,3,8
2008,Summer,Kazakhstan,KAZ,2,3,4,9
2012,Summer,Kazakhstan,KAZ,3,2,6,11
2016,Summer,Kazakhstan,KAZ,3,5,10,18
2020-21,Summer,Kazakhstan,KAZ,0,0,8,8
1964,Summer,Kenya,KEN,0,0,1,1
1968,Summer,Kenya,KEN,3,4,2,9
1972,Summer,Kenya,KEN,2,3,4,9
1984,Summer,Kenya,KEN,1,0,2,3
1988,Summer,Kenya,KEN,5,2,2,9
1992,Summer,Kenya,KEN,2,4,2,8
1996,Summer,Kenya,KEN,1,4,3,8
2000,Summer,Kenya,KEN,2,3,2,7
2004,Summer,Kenya,KEN,1,4,2,7
2008,Summer,Kenya,KEN,6,4,6,16
2012,Summer,Kenya,KEN,2,4,7,13
2016,Summer,Kenya,KEN,6,6,1,13
2020-21,Summer,Kenya,KEN,4,4,2,10
2016,Summer,Kosovo,KOS,1,0,0,1
2020-21,Summer,Kosovo,KOS,2,0,0,2
2000,Summer,Kuwait,KUW,0,0,1,1
2012,Summer,Kuwait,KUW,0,0,1,1
2020-21,Summer,Kuwait,KUW,0,0,1,1
2000,Summer,Kyrgyzstan,KGZ,0,0,1,1
2008,Summer,Kyrgyzstan,KGZ,0,1,2,3
2020-21,Summer,Kyrgyzstan,KGZ,0,2,1,3
1992,Summer,Latvia,LAT,0,2,1,3
1996,Summer,Latvia,LAT,0,1,0,1
2000,Summer,Latvia,LAT,1,1,1,3
2004,Summer,Latvia,LAT,0,4,0,4
2008,Summer,Latvia,LAT,1,1,1,3
2012,Summer,Latvia,LAT,1,0,1,2
2020-21,Summer,Latvia,LAT,1,0,1,2
1972,Summer,Lebanon,LBN,0,1,0,1
1980,Summer,Lebanon,LBN,0,0,1,1
1992,Summer,Lithuania,LTU,1,0,1,2
1996,Summer,Lithuania,LTU,0,0,1,1
2000,Summer,Lithuania,LTU,2,0,3,5
2004,Summer,Lithuania,LTU,1,2,0,3
2008,Summer,Lithuania,LTU,0,3,2,5
2012,Summer,Lithuania,LTU,2,0,3,5
2016,Summer,Lithuania,LTU,0,1,3,4
2020-21,Summer,Lithuania,LTU,0,1,0,1
2000,Summer,Macedonia,MKD,0,0,1,1
1992,Summer,Malaysia,MAS,0,0,1,1
1996,Summer,Malaysia,MAS,0,1,1,2
2008,Summer,Malaysia,MAS,0,1,0,1
2012,Summer,Malaysia,MAS,0,1,1,2
2016,Summer,Malaysia,MAS,0,4,1,5
2020-21,Summer,Malaysia,MAS,0,1,1,2
2008,Summer,Mauritius,MRI,0,0,1,1
1964,Summer,Mexico,MEX,0,0,1,1
1972,Summer,Mexico,MEX,0,1,0,1
1976,Summer,Mexico,MEX,1,0,1,2
1980,Summer,Mexico,MEX,0,1,3,4
1984,Summer,Mexico,MEX,2,3,1,6
1988,Summer,Mexico,MEX,0,0,2,2
1992,Summer,Mexico,MEX,0,1,0,1
1996,Summer,Mexico,MEX,0,0,1,1
2000,Summer,Mexico,MEX,1,2,3,6
2004,Summer,Mexico,MEX,0,3,1,4
2008,Summer,Mexico,MEX,2,0,2,4
2012,Summer,Mexico,MEX,1,3,4,8
2016,Summer,Mexico,MEX,0,3,2,5
1960,Summer,Mexico,MEX,0,0,1,1
2020-21,Summer,Mexico,MEX,0,0,4,4
1968,Summer,Mexico*,MEX,3,3,3,9
1996,Summer,Moldova,MDA,0,1,1,2
2000,Summer,Moldova,MDA,0,1,1,2
2008,Summer,Moldova,MDA,0,0,1,1
2020-21,Summer,Moldova,MDA,0,0,1,1
1968,Summer,Mongolia,MGL,0,1,3,4
1972,Summer,Mongolia,MGL,0,1,0,1
1976,Summer,Mongolia,MGL,0,1,0,1
1980,Summer,Mongolia,MGL,0,2,2,4
1988,Summer,Mongolia,MGL,0,0,1,1
1992,Summer,Mongolia,MGL,0,0,2,2
1996,Summer,Mongolia,MGL,0,0,1,1
2004,Summer,Mongolia,MGL,0,0,1,1
2008,Summer,Mongolia,MGL,2,2,0,4
2012,Summer,Mongolia,MGL,0,2,3,5
2016,Summer,Mongolia,MGL,0,1,1,2
2020-21,Summer,Mongolia,MGL,0,1,3,4
2012,Summer,Montenegro,MNE,0,1,0,1
1984,Summer,Morocco,MAR,2,0,0,2
1988,Summer,Morocco,MAR,1,0,2,3
1992,Summer,Morocco,MAR,1,1,1,3
1996,Summer,Morocco,MAR,0,0,2,2
2000,Summer,Morocco,MAR,0,1,4,5
2004,Summer,Morocco,MAR,2,1,0,3
2008,Summer,Morocco,MAR,0,1,1,2
2012,Summer,Morocco,MAR,0,0,1,1
2016,Summer,Morocco,MAR,0,0,1,1
1960,Summer,Morocco,MAR,0,1,0,1
2020-21,Summer,Morocco,MAR,1,0,0,1
1996,Summer,Mozambique,MOZ,0,0,1,1
2000,Summer,Mozambique,MOZ,1,0,0,1
1992,Summer,Namibia,NAM,0,2,0,2
1996,Summer,Namibia,NAM,0,2,0,2
2020-21,Summer,Namibia,NAM,0,1,0,1
1964,Summer,Netherlands,NED,2,4,4,10
1968,Summer,Netherlands,NED,3,3,1,7
1972,Summer,Netherlands,NED,3,1,1,5
1976,Summer,Netherlands,NED,0,2,3,5
1980,Summer,Netherlands,NED,0,1,2,3
1984,Summer,Netherlands,NED,5,2,6,13
1988,Summer,Netherlands,NED,2,2,5,9
1992,Summer,Netherlands,NED,2,6,7,15
1996,Summer,Netherlands,NED,4,5,10,19
2000,Summer,Netherlands,NED,12,9,4,25
2004,Summer,Netherlands,NED,4,9,9,22
2008,Summer,Netherlands,NED,7,5,4,16
2012,Summer,Netherlands,NED,6,6,8,20
2016,Summer,Netherlands,NED,8,7,4,19
1988,Summer,Netherlands Antilles,AHO,0,1,0,1
1960,Summer,Netherlands,NED,0,1,2,3
2020-21,Summer,Netherlands,NED,10,12,14,36
1964,Summer,New Zealand,NZL,3,0,2,5
1968,Summer,New Zealand,NZL,1,0,2,3
1972,Summer,New Zealand,NZL,1,1,1,3
1976,Summer,New Zealand,NZL,2,1,1,4
1984,Summer,New Zealand,NZL,8,1,2,11
1988,Summer,New Zealand,NZL,3,2,8,13
1992,Summer,New Zealand,NZL,1,4,5,10
1996,Summer,New Zealand,NZL,3,2,1,6
2000,Summer,New Zealand,NZL,1,0,3,4
2004,Summer,New Zealand,NZL,3,2,0,5
2008,Summer,New Zealand,NZL,3,2,4,9
2012,Summer,New Zealand,NZL,6,2,5,13
2016,Summer,New Zealand,NZL,4,9,5,18
1960,Summer,New Zealand,NZL,2,0,1,3
2020-21,Summer,New Zealand,NZL,7,6,7,20
1972,Summer,Niger,NIG,0,0,1,1
2016,Summer,Niger,NIG,0,1,0,1
1964,Summer,Nigeria,NGR,0,0,1,1
1972,Summer,Nigeria,NGR,0,0,1,1
1984,Summer,Nigeria,NGR,0,1,1,2
1992,Summer,Nigeria,NGR,0,3,1,4
1996,Summer,Nigeria,NGR,2,1,3,6
2000,Summer,Nigeria,NGR,1,2,0,3
2004,Summer,Nigeria,NGR,0,0,2,2
2008,Summer,Nigeria,NGR,0,3,2,5
2016,Summer,Nigeria,NGR,0,0,1,1
2020-21,Summer,Nigeria,NGR,0,1,1,2
1972,Summer,North Korea,PRK,1,1,3,5
1976,Summer,North Korea,PRK,1,1,0,2
1980,Summer,North Korea,PRK,0,3,2,5
1992,Summer,North Korea,PRK,4,0,5,9
1996,Summer,North Korea,PRK,2,1,2,5
2000,Summer,North Korea,PRK,0,1,3,4
2004,Summer,North Korea,PRK,0,4,1,5
2008,Summer,North Korea,PRK,2,2,2,6
2012,Summer,North Korea,PRK,4,0,3,7
2016,Summer,North Korea,PRK,2,3,2,7
2020-21,Summer,North Macedonia,MKD,0,1,0,1
1968,Summer,Norway,NOR,1,1,0,2
1972,Summer,Norway,NOR,2,1,1,4
1976,Summer,Norway,NOR,1,1,0,2
1984,Summer,Norway,NOR,0,1,2,3
1988,Summer,Norway,NOR,2,3,0,5
1992,Summer,Norway,NOR,2,4,1,7
1996,Summer,Norway,NOR,2,2,3,7
2000,Summer,Norway,NOR,4,3,3,10
2004,Summer,Norway,NOR,5,0,1,6
2008,Summer,Norway,NOR,3,5,1,9
2012,Summer,Norway,NOR,2,1,1,4
2016,Summer,Norway,NOR,0,0,4,4
1960,Summer,Norway,NOR,1,0,0,1
2020-21,Summer,Norway,NOR,4,2,2,8
1964,Summer,Pakistan,PAK,0,1,0,1
1968,Summer,Pakistan,PAK,1,0,0,1
1972,Summer,Pakistan,PAK,0,1,0,1
1976,Summer,Pakistan,PAK,0,0,1,1
1984,Summer,Pakistan,PAK,1,0,0,1
1988,Summer,Pakistan,PAK,0,0,1,1
1992,Summer,Pakistan,PAK,0,0,1,1
1960,Summer,Pakistan,PAK,1,0,1,2
2008,Summer,Panama,PAN,1,0,0,1
2004,Summer,Paraguay,PAR,0,1,0,1
1984,Summer,Peru,PER,0,1,0,1
1988,Summer,Peru,PER,0,1,0,1
1992,Summer,Peru,PER,0,1,0,1
1964,Summer,Philippines,PHI,0,1,0,1
1988,Summer,Philippines,PHI,0,0,1,1
1992,Summer,Philippines,PHI,0,0,1,1
1996,Summer,Philippines,PHI,0,1,0,1
2016,Summer,Philippines,PHI,0,1,0,1
2020-21,Summer,Philippines,PHI,1,2,1,4
1964,Summer,Poland,POL,7,6,10,23
1968,Summer,Poland,POL,5,2,11,18
1972,Summer,Poland,POL,7,5,9,21
1976,Summer,Poland,POL,7,6,13,26
1980,Summer,Poland,POL,3,14,15,32
1988,Summer,Poland,POL,2,5,9,16
1992,Summer,Poland,POL,3,6,10,19
1996,Summer,Poland,POL,7,5,5,17
2000,Summer,Poland,POL,6,5,3,14
2004,Summer,Poland,POL,3,2,5,10
2008,Summer,Poland,POL,4,5,2,11
2012,Summer,Poland,POL,3,2,6,11
2016,Summer,Poland,POL,2,3,6,11
1960,Summer,Poland,POL,4,6,11,21
2020-21,Summer,Poland,POL,4,5,5,14
1976,Summer,Portugal,POR,0,2,0,2
1984,Summer,Portugal,POR,1,0,2,3
1988,Summer,Portugal,POR,1,0,0,1
1996,Summer,Portugal,POR,1,0,1,2
2000,Summer,Portugal,POR,0,0,2,2
2004,Summer,Portugal,POR,0,2,1,3
2008,Summer,Portugal,POR,1,1,0,2
2012,Summer,Portugal,POR,0,1,0,1
2016,Summer,Portugal,POR,0,0,1,1
1960,Summer,Portugal,POR,0,1,0,1
2020-21,Summer,Portugal,POR,1,1,2,4
1976,Summer,Puerto Rico,PUR,0,0,1,1
1984,Summer,Puerto Rico,PUR,0,1,1,2
1992,Summer,Puerto Rico,PUR,0,0,1,1
1996,Summer,Puerto Rico,PUR,0,0,1,1
2012,Summer,Puerto Rico,PUR,0,1,1,2
2016,Summer,Puerto Rico,PUR,1,0,0,1
2020-21,Summer,Puerto Rico,PUR,1,0,0,1
1992,Summer,Qatar,QAT,0,0,1,1
2000,Summer,Qatar,QAT,0,0,1,1
2012,Summer,Qatar,QAT,0,1,1,2
2016,Summer,Qatar,QAT,0,1,0,1
2020-21,Summer,Qatar,QAT,2,0,1,3
2020-21,Summer,ROC ,ROC,20,28,23,71
1964,Summer,Romania,ROU,2,4,6,12
1968,Summer,Romania,ROU,4,6,5,15
1972,Summer,Romania,ROU,3,6,7,16
1976,Summer,Romania,ROU,4,9,14,27
1980,Summer,Romania,ROU,6,6,13,25
1984,Summer,Romania,ROU,20,16,17,53
1988,Summer,Romania,ROU,7,11,6,24
1992,Summer,Romania,ROU,4,6,8,18
1996,Summer,Romania,ROU,4,7,9,20
2000,Summer,Romania,ROU,11,6,9,26
2004,Summer,Romania,ROU,8,5,6,19
2008,Summer,Romania,ROU,4,1,4,9
2012,Summer,Romania,ROU,2,4,1,7
2016,Summer,Romania,ROU,1,1,2,4
1960,Summer,Romania,ROU,3,1,6,10
2020-21,Summer,Romania,ROU,1,3,0,4
1996,Summer,Russia,RUS,26,21,16,63
2000,Summer,Russia,RUS,32,28,29,89
2004,Summer,Russia,RUS,28,26,36,90
2008,Summer,Russia,RUS,24,13,23,60
2012,Summer,Russia,RUS,20,21,27,68
2016,Summer,Russia,RUS,19,17,20,56
2008,Summer,Samoa,SAM,0,1,0,1
2020-21,Summer,San Marino ,SMR,0,1,2,3
2000,Summer,Saudi Arabia,KSA,0,1,1,2
2012,Summer,Saudi Arabia,KSA,0,0,1,1
2020-21,Summer,Saudi Arabia,KSA,0,1,0,1
1988,Summer,Senegal,SEN,0,1,0,1
2008,Summer,Serbia,SRB,0,1,2,3
2012,Summer,Serbia,SRB,1,1,2,4
2016,Summer,Serbia,SRB,2,4,2,8
2004,Summer,Serbia and Montenegro,SCG,0,2,0,2
2020-21,Summer,Serbia,SRB,3,1,5,9
2008,Summer,Singapore,SGP,0,1,0,1
2012,Summer,Singapore,SGP,0,0,2,2
2016,Summer,Singapore,SGP,1,0,0,1
1960,Summer,Singapore,SGP,0,1,0,1
1996,Summer,Slovakia,SVK,1,1,1,3
2000,Summer,Slovakia,SVK,1,3,1,5
2004,Summer,Slovakia,SVK,2,2,2,6
2008,Summer,Slovakia,SVK,3,3,0,6
2012,Summer,Slovakia,SVK,0,1,3,4
2016,Summer,Slovakia,SVK,2,2,0,4
2020-21,Summer,Slovakia,SVK,1,2,1,4
1992,Summer,Slovenia,SLO,0,0,2,2
1996,Summer,Slovenia,SLO,0,2,0,2
2000,Summer,Slovenia,SLO,2,0,0,2
2004,Summer,Slovenia,SLO,0,1,3,4
2008,Summer,Slovenia,SLO,1,2,2,5
2012,Summer,Slovenia,SLO,1,1,2,4
2016,Summer,Slovenia,SLO,1,2,1,4
2020-21,Summer,Slovenia,SLO,3,1,1,5
1992,Summer,South Africa,RSA,0,2,0,2
1996,Summer,South Africa,RSA,3,1,1,5
2000,Summer,South Africa,RSA,0,2,3,5
2004,Summer,South Africa,RSA,1,3,2,6
2008,Summer,South Africa,RSA,0,1,0,1
2012,Summer,South Africa,RSA,4,1,1,6
2016,Summer,South Africa,RSA,2,6,2,10
1960,Summer,South Africa,RSA,0,1,2,3
2020-21,Summer,South Africa,RSA,1,2,0,3
1964,Summer,South Korea,KOR,0,2,1,3
1968,Summer,South Korea,KOR,0,1,1,2
1972,Summer,South Korea,KOR,0,1,0,1
1976,Summer,South Korea,KOR,1,1,4,6
1984,Summer,South Korea,KOR,6,6,7,19
1992,Summer,South Korea,KOR,12,5,12,29
1996,Summer,South Korea,KOR,7,15,5,27
2000,Summer,South Korea,KOR,8,10,10,28
2004,Summer,South Korea,KOR,9,12,9,30
2008,Summer,South Korea,KOR,13,11,8,32
2012,Summer,South Korea,KOR,13,9,8,30
2016,Summer,South Korea,KOR,9,3,9,21
2020-21,Summer,South Korea,KOR,6,4,10,20
1988,Summer,South Korea*,KOR,12,10,11,33
1964,Summer,Soviet Union,"SOV (1968 W)
code from French Union des républiques socialistes soviétiques (URSS)",30,31,35,96
1968,Summer,Soviet Union,"SOV (1968 W)
code from French Union des républiques socialistes soviétiques (URSS)",29,32,30,91
1972,Summer,Soviet Union,"SOV (1968 W)
code from French Union des républiques socialistes soviétiques (URSS)",50,27,22,99
1976,Summer,Soviet Union,"SOV (1968 W)
code from French Union des républiques socialistes soviétiques (URSS)",49,41,35,125
1988,Summer,Soviet Union,"SOV (1968 W)
code from French Union des républiques socialistes soviétiques (URSS)",55,31,46,132
1960,Summer,Soviet Union,"SOV (1968 W)
code from French Union des républiques socialistes soviétiques (URSS)",43,29,31,103
1980,Summer,Soviet Union*,"SOV (1968 W)
code from French Union des républiques socialistes soviétiques (URSS)",80,69,46,195
1972,Summer,Spain,ESP,0,0,1,1
1976,Summer,Spain,ESP,0,2,0,2
1980,Summer,Spain,ESP,1,3,2,6
1984,Summer,Spain,ESP,1,2,2,5
1988,Summer,Spain,ESP,1,1,2,4
1996,Summer,Spain,ESP,5,6,6,17
2000,Summer,Spain,ESP,3,3,5,11
2004,Summer,Spain,ESP,3,11,6,20
2008,Summer,Spain,ESP,5,11,3,19
2012,Summer,Spain,ESP,4,10,6,20
2016,Summer,Spain,ESP,7,4,6,17
1960,Summer,Spain,ESP,0,0,1,1
2020-21,Summer,Spain,ESP,3,8,6,17
1992,Summer,Spain*,ESP,13,7,2,22
2000,Summer,Sri Lanka,SRI,0,1,0,1
2008,Summer,Sudan,SUD,0,1,0,1
1988,Summer,Suriname,SUR,1,0,0,1
1992,Summer,Suriname,SUR,0,0,1,1
1964,Summer,Sweden,SWE,2,2,4,8
1968,Summer,Sweden,SWE,2,1,1,4
1972,Summer,Sweden,SWE,4,6,6,16
1976,Summer,Sweden,SWE,4,1,0,5
1980,Summer,Sweden,SWE,3,3,6,12
1984,Summer,Sweden,SWE,2,11,6,19
1988,Summer,Sweden,SWE,0,4,7,11
1992,Summer,Sweden,SWE,1,7,4,12
1996,Summer,Sweden,SWE,2,4,2,8
2000,Summer,Sweden,SWE,4,5,3,12
2004,Summer,Sweden,SWE,4,2,1,7
2008,Summer,Sweden,SWE,0,4,1,5
2012,Summer,Sweden,SWE,1,4,3,8
2016,Summer,Sweden,SWE,2,6,3,11
1960,Summer,Sweden,SWE,1,2,3,6
2020-21,Summer,Sweden,SWE,3,6,0,9
1964,Summer,Switzerland,SUI,1,2,1,4
1968,Summer,Switzerland,SUI,0,1,4,5
1972,Summer,Switzerland,SUI,0,3,0,3
1976,Summer,Switzerland,SUI,1,1,2,4
1980,Summer,Switzerland,SUI,2,0,0,2
1984,Summer,Switzerland,SUI,0,4,4,8
1988,Summer,Switzerland,SUI,0,2,2,4
1992,Summer,Switzerland,SUI,1,0,0,1
1996,Summer,Switzerland,SUI,4,3,0,7
2000,Summer,Switzerland,SUI,1,6,2,9
2004,Summer,Switzerland,SUI,1,1,3,5
2008,Summer,Switzerland,SUI,2,1,4,7
2012,Summer,Switzerland,SUI,2,2,0,4
2016,Summer,Switzerland,SUI,3,2,2,7
1960,Summer,Switzerland,SUI,0,3,3,6
2020-21,Summer,Switzerland,SUI,3,4,6,13
1984,Summer,Syria,SYR,0,1,0,1
1996,Summer,Syria,SYR,1,0,0,1
2004,Summer,Syria,SYR,0,0,1,1
2020-21,Summer,Syria,SYR,0,0,1,1
1968,Summer,Taiwan,TWN,0,0,1,1
2008,Summer,Tajikistan,TJK,0,1,1,2
2012,Summer,Tajikistan,TJK,0,0,1,1
2016,Summer,Tajikistan,TJK,1,0,0,1
1980,Summer,Tanzania,TAN,0,2,0,2
1976,Summer,Thailand,THA,0,0,1,1
1984,Summer,Thailand,THA,0,1,0,1
1988,Summer,Thailand,THA,0,0,1,1
1992,Summer,Thailand,THA,0,0,1,1
1996,Summer,Thailand,THA,1,0,1,2
2000,Summer,Thailand,THA,1,0,2,3
2004,Summer,Thailand,THA,3,1,4,8
2008,Summer,Thailand,THA,2,2,2,6
2012,Summer,Thailand,THA,0,2,2,4
2016,Summer,Thailand,THA,2,2,2,6
2020-21,Summer,Thailand,THA,1,0,1,2
2008,Summer,Togo,TOG,0,0,1,1
1996,Summer,Tonga,TGA,0,1,0,1
1964,Summer,Trinidad and Tobago,TTO,0,1,2,3
1976,Summer,Trinidad and Tobago,TTO,1,0,0,1
1996,Summer,Trinidad and Tobago,TTO,0,0,2,2
2000,Summer,Trinidad and Tobago,TTO,0,1,1,2
2004,Summer,Trinidad and Tobago,TTO,0,0,1,1
2008,Summer,Trinidad and Tobago,TTO,1,1,0,2
2012,Summer,Trinidad and Tobago,TTO,1,1,2,4
2016,Summer,Trinidad and Tobago,TTO,0,0,1,1
1964,Summer,Tunisia,TUN,0,1,1,2
1968,Summer,Tunisia,TUN,1,0,1,2
1972,Summer,Tunisia,TUN,0,1,0,1
1996,Summer,Tunisia,TUN,0,0,1,1
2008,Summer,Tunisia,TUN,1,0,0,1
2012,Summer,Tunisia,TUN,2,0,1,3
2016,Summer,Tunisia,TUN,0,0,3,3
2020-21,Summer,Tunisia,TUN,1,1,0,2
1964,Summer,Turkey,TUR,2,3,1,6
1968,Summer,Turkey,TUR,2,0,0,2
1972,Summer,Turkey,TUR,0,1,0,1
1984,Summer,Turkey,TUR,0,0,3,3
1988,Summer,Turkey,TUR,1,1,0,2
1992,Summer,Turkey,TUR,2,2,2,6
1996,Summer,Turkey,TUR,4,1,1,6
2000,Summer,Turkey,TUR,3,0,2,5
2004,Summer,Turkey,TUR,3,3,5,11
2008,Summer,Turkey,TUR,1,1,3,5
2012,Summer,Turkey,TUR,1,1,1,3
2016,Summer,Turkey,TUR,1,3,4,8
1960,Summer,Turkey,TUR,7,2,0,9
2020-21,Summer,Turkey,TUR,2,2,9,13
2020-21,Summer,Turkmenistan ,TKM,0,1,0,1
1968,Summer,Uganda,UGA,0,1,1,2
1972,Summer,Uganda,UGA,1,1,0,2
1980,Summer,Uganda,UGA,0,1,0,1
1996,Summer,Uganda,UGA,0,0,1,1
2012,Summer,Uganda,UGA,1,0,0,1
2020-21,Summer,Uganda,UGA,2,1,1,4
1996,Summer,Ukraine,UKR,9,2,12,23
2000,Summer,Ukraine,UKR,3,10,10,23
2004,Summer,Ukraine,UKR,8,5,9,22
2008,Summer,Ukraine,UKR,7,4,11,22
2012,Summer,Ukraine,UKR,5,4,10,19
2016,Summer,Ukraine,UKR,2,5,4,11
2020-21,Summer,Ukraine,UKR,1,6,12,19
1992,Summer,Unified Team,EUN,45,38,29,112
2004,Summer,United Arab Emirates,UAE,1,0,0,1
2016,Summer,United Arab Emirates,UAE,0,0,1,1
1964,Summer,United States,USA,36,26,28,90
1968,Summer,United States,USA,45,28,34,107
1972,Summer,United States,USA,33,31,30,94
1976,Summer,United States,USA,34,35,25,94
1988,Summer,United States,USA,36,31,27,94
1992,Summer,United States,USA,37,34,37,108
2000,Summer,United States,USA,37,24,32,93
2004,Summer,United States,USA,36,39,26,101
2008,Summer,United States,USA,36,39,37,112
2012,Summer,United States,USA,47,27,30,104
2016,Summer,United States,USA,46,37,38,121
1960,Summer,United States,USA,34,21,16,71
2020-21,Summer,United States,USA,39,41,33,113
1984,Summer,United States*,USA,83,61,30,174
1996,Summer,United States*,USA,44,32,25,101
1964,Summer,United Team of Germany,EUA,10,22,18,50
1960,Summer,United Team of Germany ,EUA,12,19,11,42
1964,Summer,Uruguay,URU,0,0,1,1
2000,Summer,Uruguay,URU,0,1,0,1
1996,Summer,Uzbekistan,UZB,0,1,1,2
2000,Summer,Uzbekistan,UZB,1,1,2,4
2004,Summer,Uzbekistan,UZB,2,1,2,5
2008,Summer,Uzbekistan,UZB,0,1,3,4
2012,Summer,Uzbekistan,UZB,0,0,3,3
2016,Summer,Uzbekistan,UZB,4,2,7,13
2020-21,Summer,Uzbekistan,UZB,3,0,2,5
1968,Summer,Venezuela,VEN,1,0,0,1
1976,Summer,Venezuela,VEN,0,1,0,1
1980,Summer,Venezuela,VEN,0,1,0,1
1984,Summer,Venezuela,VEN,0,0,3,3
2004,Summer,Venezuela,VEN,0,0,2,2
2008,Summer,Venezuela,VEN,0,0,1,1
2012,Summer,Venezuela,VEN,1,0,0,1
2016,Summer,Venezuela,VEN,0,2,1,3
1960,Summer,Venezuela,VEN,0,0,1,1
2020-21,Summer,Venezuela,VEN,1,3,0,4
2000,Summer,Vietnam,VIE,0,1,0,1
2008,Summer,Vietnam,VIE,0,1,0,1
2012,Summer,Vietnam,VIE,0,0,1,1
2016,Summer,Vietnam,VIE,1,1,0,2
1988,Summer,Virgin Islands,ISV,0,1,0,1
1968,Summer,West Germany,FRG,5,11,10,26
1976,Summer,West Germany,FRG,10,12,17,39
1984,Summer,West Germany,FRG,17,19,23,59
1988,Summer,West Germany,FRG,11,14,15,40
1972,Summer,West Germany*,FRG,13,11,16,40
1964,Summer,Yugoslavia,YUG,2,1,2,5
1968,Summer,Yugoslavia,YUG,3,3,2,8
1972,Summer,Yugoslavia,YUG,2,1,2,5
1976,Summer,Yugoslavia,YUG,2,3,3,8
1980,Summer,Yugoslavia,YUG,2,3,4,9
1984,Summer,Yugoslavia,YUG,7,4,7,18
1988,Summer,Yugoslavia,YUG,3,4,5,12
1960,Summer,Yugoslavia ,YUG,1,1,0,2
1984,Summer,Zambia,ZAM,0,0,1,1
1996,Summer,Zambia,ZAM,0,1,0,1
1980,Summer,Zimbabwe,ZIM,1,0,0,1
2004,Summer,Zimbabwe,ZIM,1,1,1,3
2008,Summer,Zimbabwe,ZIM,1,3,0,4
1960,Winter,Austria,AUT,1,2,3,6
1960,Winter,Canada,CAN,2,1,1,4
1960,Winter,Czechoslovakia,TCH,0,1,0,1
1960,Winter,Finland,FIN,2,3,3,8
1960,Winter,France,FRA,1,0,2,3
1960,Winter,Italy,ITA,0,0,1,1
1960,Winter,Netherlands,NED,0,1,1,2
1960,Winter,Norway,NOR,3,3,0,6
1960,Winter,Poland,POL,0,1,1,2
1960,Winter,Soviet Union,URS,7,5,9,21
1960,Winter,Sweden,SWE,3,2,2,7
1960,Winter,Switzerland,SUI,2,0,0,2
1960,Winter,United States*,USA,3,4,3,10
1960,Winter,United Team of Germany,EUA,4,3,1,8
1964,Winter,Austria*,AUT,4,5,3,12
1964,Winter,Canada,CAN,1,1,1,3
1964,Winter,Czechoslovakia,TCH,0,0,1,1
1964,Winter,Finland,FIN,3,4,3,10
1964,Winter,France,FRA,3,4,0,7
1964,Winter,Great Britain,GBR,1,0,0,1
1964,Winter,Italy,ITA,0,1,3,4
1964,Winter,Netherlands,NED,1,1,0,2
1964,Winter,North Korea,PRK,0,1,0,1
1964,Winter,Norway,NOR,3,6,6,15
1964,Winter,Soviet Union,URS,11,8,6,25
1964,Winter,Sweden,SWE,3,3,1,7
1964,Winter,United States,USA,1,2,4,7
1964,Winter,United Team of Germany,EUA,3,3,3,9
1968,Winter,Austria,AUT,3,4,4,11
1968,Winter,Canada,CAN,1,1,1,3
1968,Winter,Czechoslovakia,TCH,1,2,1,4
1968,Winter,East Germany,GDR,1,2,2,5
1968,Winter,Finland,FIN,1,2,2,5
1968,Winter,France*,FRA,4,3,2,9
1968,Winter,Italy,ITA,4,0,0,4
1968,Winter,Netherlands,NED,3,3,3,9
1968,Winter,Norway,NOR,6,6,2,14
1968,Winter,Romania,ROU,0,0,1,1
1968,Winter,Soviet Union,URS,5,5,3,13
1968,Winter,Sweden,SWE,3,2,3,8
1968,Winter,Switzerland,SUI,0,2,4,6
1968,Winter,United States,USA,1,5,1,7
1968,Winter,West Germany,FRG,2,2,3,7
1972,Winter,Austria,AUT,1,2,2,5
1972,Winter,Canada,CAN,0,1,0,1
1972,Winter,Czechoslovakia,TCH,1,0,2,3
1972,Winter,East Germany,GDR,4,3,7,14
1972,Winter,Finland,FIN,0,4,1,5
1972,Winter,France,FRA,0,1,2,3
1972,Winter,Italy,ITA,2,2,1,5
1972,Winter,Japan*,JPN,1,1,1,3
1972,Winter,Netherlands,NED,4,3,2,9
1972,Winter,Norway,NOR,2,5,5,12
1972,Winter,Poland,POL,1,0,0,1
1972,Winter,Soviet Union,URS,8,5,3,16
1972,Winter,Spain,ESP,1,0,0,1
1972,Winter,Sweden,SWE,1,1,2,4
1972,Winter,Switzerland,SUI,4,3,3,10
1972,Winter,United States,USA,3,2,3,8
1972,Winter,West Germany,FRG,3,1,1,5
1976,Winter,Austria*,AUT,2,2,2,6
1976,Winter,Canada,CAN,1,1,1,3
1976,Winter,Czechoslovakia,TCH,0,1,0,1
1976,Winter,East Germany,GDR,7,5,7,19
1976,Winter,Finland,FIN,2,4,1,7
1976,Winter,France,FRA,0,0,1,1
1976,Winter,Great Britain,GBR,1,0,0,1
1976,Winter,Italy,ITA,1,2,1,4
1976,Winter,Liechtenstein,LIE,0,0,2,2
1976,Winter,Netherlands,NED,1,2,3,6
1976,Winter,Norway,NOR,3,3,1,7
1976,Winter,Soviet Union,URS,13,6,8,27
1976,Winter,Sweden,SWE,0,0,2,2
1976,Winter,Switzerland,SUI,1,3,1,5
1976,Winter,United States,USA,3,3,4,10
1976,Winter,West Germany,FRG,2,5,3,10
1980,Winter,Austria,AUT,3,2,2,7
1980,Winter,Bulgaria,BUL,0,0,1,1
1980,Winter,Canada,CAN,0,1,1,2
1980,Winter,Czechoslovakia,TCH,0,0,1,1
1980,Winter,East Germany,GDR,9,7,7,23
1980,Winter,Finland,FIN,1,5,3,9
1980,Winter,France,FRA,0,0,1,1
1980,Winter,Great Britain,GBR,1,0,0,1
1980,Winter,Hungary,HUN,0,1,0,1
1980,Winter,Italy,ITA,0,2,0,2
1980,Winter,Japan,JPN,0,1,0,1
1980,Winter,Liechtenstein,LIE,2,2,0,4
1980,Winter,Netherlands,NED,1,2,1,4
1980,Winter,Norway,NOR,1,3,6,10
1980,Winter,Soviet Union,URS,10,6,6,22
1980,Winter,Sweden,SWE,3,0,1,4
1980,Winter,Switzerland,SUI,1,1,3,5
1980,Winter,United States*,USA,6,4,2,12
1980,Winter,West Germany,FRG,0,2,3,5
1984,Winter,Austria,AUT,0,0,1,1
1984,Winter,Canada,CAN,2,1,1,4
1984,Winter,Czechoslovakia,TCH,0,2,4,6
1984,Winter,East Germany,GDR,9,9,6,24
1984,Winter,Finland,FIN,4,3,6,13
1984,Winter,France,FRA,0,1,2,3
1984,Winter,Great Britain,GBR,1,0,0,1
1984,Winter,Italy,ITA,2,0,0,2
1984,Winter,Japan,JPN,0,1,0,1
1984,Winter,Liechtenstein,LIE,0,0,2,2
1984,Winter,Norway,NOR,3,2,4,9
1984,Winter,Soviet Union,URS,6,10,9,25
1984,Winter,Sweden,SWE,4,2,2,8
1984,Winter,Switzerland,SUI,2,2,1,5
1984,Winter,United States,USA,4,4,0,8
1984,Winter,West Germany,FRG,2,1,1,4
1984,Winter,Yugoslavia*,YUG,0,1,0,1
1988,Winter,Austria,AUT,3,5,2,10
1988,Winter,Canada*,CAN,0,2,3,5
1988,Winter,Czechoslovakia,TCH,0,1,2,3
1988,Winter,East Germany,GDR,9,10,6,25
1988,Winter,Finland,FIN,4,1,2,7
1988,Winter,France,FRA,1,0,1,2
1988,Winter,Italy,ITA,2,1,2,5
1988,Winter,Japan,JPN,0,0,1,1
1988,Winter,Liechtenstein,LIE,0,0,1,1
1988,Winter,Netherlands,NED,3,2,2,7
1988,Winter,Norway,NOR,0,3,2,5
1988,Winter,Soviet Union,URS,11,9,9,29
1988,Winter,Sweden,SWE,4,0,2,6
1988,Winter,Switzerland,SUI,5,5,5,15
1988,Winter,United States,USA,2,1,3,6
1988,Winter,West Germany,FRG,2,4,2,8
1988,Winter,Yugoslavia,YUG,0,2,1,3
1992,Winter,Austria,AUT,6,7,8,21
1992,Winter,Canada,CAN,2,3,2,7
1992,Winter,China,CHN,0,3,0,3
1992,Winter,Czechoslovakia,TCH,0,0,3,3
1992,Winter,Finland,FIN,3,1,3,7
1992,Winter,France*,FRA,3,5,1,9
1992,Winter,Germany,GER,10,10,6,26
1992,Winter,Italy,ITA,4,6,4,14
1992,Winter,Japan,JPN,1,2,4,7
1992,Winter,Luxembourg,LUX,0,2,0,2
1992,Winter,Netherlands,NED,1,1,2,4
1992,Winter,New Zealand,NZL,0,1,0,1
1992,Winter,North Korea,PRK,0,0,1,1
1992,Winter,Norway,NOR,9,6,5,20
1992,Winter,South Korea,KOR,2,1,1,4
1992,Winter,Spain,ESP,0,0,1,1
1992,Winter,Sweden,SWE,1,0,3,4
1992,Winter,Switzerland,SUI,1,0,2,3
1992,Winter,Unified Team,EUN,9,6,8,23
1992,Winter,United States,USA,5,4,2,11
1994,Winter,Australia,AUS,0,0,1,1
1994,Winter,Austria,AUT,2,3,4,9
1994,Winter,Belarus,BLR,0,2,0,2
1994,Winter,Canada,CAN,3,6,4,13
1994,Winter,China,CHN,0,1,2,3
1994,Winter,Finland,FIN,0,1,5,6
1994,Winter,France,FRA,0,1,4,5
1994,Winter,Germany,GER,9,7,8,24
1994,Winter,Great Britain,GBR,0,0,2,2
1994,Winter,Italy,ITA,7,5,8,20
1994,Winter,Japan,JPN,1,2,2,5
1994,Winter,Kazakhstan,KAZ,1,2,0,3
1994,Winter,Netherlands,NED,0,1,3,4
1994,Winter,Norway*,NOR,10,11,5,26
1994,Winter,Russia,RUS,11,8,4,23
1994,Winter,Slovenia,SLO,0,0,3,3
1994,Winter,South Korea,KOR,4,1,1,6
1994,Winter,Sweden,SWE,2,1,0,3
1994,Winter,Switzerland,SUI,3,4,2,9
1994,Winter,Ukraine,UKR,1,0,1,2
1994,Winter,United States,USA,6,5,2,13
1994,Winter,Uzbekistan,UZB,1,0,0,1
1998,Winter,Australia,AUS,0,0,1,1
1998,Winter,Austria,AUT,3,5,9,17
1998,Winter,Belarus,BLR,0,0,2,2
1998,Winter,Belgium,BEL,0,0,1,1
1998,Winter,Bulgaria,BUL,1,0,0,1
1998,Winter,Canada,CAN,6,5,4,15
1998,Winter,China,CHN,0,6,2,8
1998,Winter,Czech Republic,CZE,1,1,1,3
1998,Winter,Denmark,DEN,0,1,0,1
1998,Winter,Finland,FIN,2,4,6,12
1998,Winter,France,FRA,2,1,5,8
1998,Winter,Germany,GER,12,9,8,29
1998,Winter,Great Britain,GBR,0,0,1,1
1998,Winter,Italy,ITA,2,6,2,10
1998,Winter,Japan*,JPN,5,1,4,10
1998,Winter,Kazakhstan,KAZ,0,0,2,2
1998,Winter,Netherlands,NED,5,4,2,11
1998,Winter,Norway,NOR,10,10,5,25
1998,Winter,Russia,RUS,9,6,3,18
1998,Winter,South Korea,KOR,3,1,2,6
1998,Winter,Sweden,SWE,0,2,1,3
1998,Winter,Switzerland,SUI,2,2,3,7
1998,Winter,Ukraine,UKR,0,1,0,1
1998,Winter,United States,USA,6,3,4,13
2002,Winter,Australia,AUS,2,0,0,2
2002,Winter,Austria,AUT,3,4,10,17
2002,Winter,Belarus,BLR,0,0,1,1
2002,Winter,Bulgaria,BUL,0,1,2,3
2002,Winter,Canada,CAN,7,3,7,17
2002,Winter,China,CHN,2,2,4,8
2002,Winter,Croatia,CRO,3,1,0,4
2002,Winter,Czech Republic,CZE,1,2,0,3
2002,Winter,Estonia,EST,1,1,1,3
2002,Winter,Finland,FIN,4,2,1,7
2002,Winter,France,FRA,4,5,2,11
2002,Winter,Germany,GER,12,16,8,36
2002,Winter,Great Britain,GBR,1,0,1,2
2002,Winter,Italy,ITA,4,4,5,13
2002,Winter,Japan,JPN,0,1,1,2
2002,Winter,Netherlands,NED,3,5,0,8
2002,Winter,Norway,NOR,13,5,7,25
2002,Winter,Poland,POL,0,1,1,2
2002,Winter,Russia,RUS,5,4,4,13
2002,Winter,Slovenia,SLO,0,0,1,1
2002,Winter,South Korea,KOR,2,2,0,4
2002,Winter,Sweden,SWE,0,2,5,7
2002,Winter,Switzerland,SUI,3,2,6,11
2002,Winter,United States*,USA,10,13,11,34
2006,Winter,Australia,AUS,1,0,1,2
2006,Winter,Austria,AUT,9,7,7,23
2006,Winter,Belarus,BLR,0,1,0,1
2006,Winter,Bulgaria,BUL,0,1,0,1
2006,Winter,Canada,CAN,7,10,7,24
2006,Winter,China,CHN,2,4,5,11
2006,Winter,Croatia,CRO,1,2,0,3
2006,Winter,Czech Republic,CZE,1,2,1,4
2006,Winter,Estonia,EST,3,0,0,3
2006,Winter,Finland,FIN,0,6,3,9
2006,Winter,France,FRA,3,2,4,9
2006,Winter,Germany,GER,11,12,6,29
2006,Winter,Great Britain,GBR,0,1,0,1
2006,Winter,Italy*,ITA,5,0,6,11
2006,Winter,Japan,JPN,1,0,0,1
2006,Winter,Latvia,LAT,0,0,1,1
2006,Winter,Netherlands,NED,3,2,4,9
2006,Winter,Norway,NOR,2,8,9,19
2006,Winter,Poland,POL,0,1,1,2
2006,Winter,Russia,RUS,8,6,8,22
2006,Winter,Slovakia,SVK,0,1,0,1
2006,Winter,South Korea,KOR,6,3,2,11
2006,Winter,Sweden,SWE,7,2,5,14
2006,Winter,Switzerland,SUI,5,4,5,14
2006,Winter,Ukraine,UKR,0,0,2,2
2006,Winter,United States,USA,9,9,7,25
2010,Winter,Australia,AUS,2,1,0,3
2010,Winter,Austria,AUT,4,6,6,16
2010,Winter,Belarus,BLR,1,1,1,3
2010,Winter,Canada*,CAN,14,7,5,26
2010,Winter,China,CHN,5,2,4,11
2010,Winter,Croatia,CRO,0,2,1,3
2010,Winter,Czech Republic,CZE,2,0,4,6
2010,Winter,Estonia,EST,0,1,0,1
2010,Winter,Finland,FIN,0,1,4,5
2010,Winter,France,FRA,2,3,6,11
2010,Winter,Germany,GER,10,13,7,30
2010,Winter,Great Britain,GBR,1,0,0,1
2010,Winter,Italy,ITA,1,1,3,5
2010,Winter,Japan,JPN,0,3,2,5
2010,Winter,Kazakhstan,KAZ,0,1,0,1
2010,Winter,Latvia,LAT,0,2,0,2
2010,Winter,Netherlands,NED,4,1,3,8
2010,Winter,Norway,NOR,9,8,6,23
2010,Winter,Poland,POL,1,3,2,6
2010,Winter,Russia,RUS,3,5,7,15
2010,Winter,Slovakia,SVK,1,1,1,3
2010,Winter,Slovenia,SLO,0,2,1,3
2010,Winter,South Korea,KOR,6,6,2,14
2010,Winter,Sweden,SWE,5,2,4,11
2010,Winter,Switzerland,SUI,6,0,3,9
2010,Winter,United States,USA,9,15,13,37
2014,Winter,Australia,AUS,0,2,1,3
2014,Winter,Austria,AUT,4,8,5,17
2014,Winter,Belarus,BLR,5,0,1,6
2014,Winter,Canada,CAN,10,10,5,25
2014,Winter,China,CHN,3,4,2,9
2014,Winter,Croatia,CRO,0,1,0,1
2014,Winter,Czech Republic,CZE,2,4,2,8
2014,Winter,Finland,FIN,1,3,1,5
2014,Winter,France,FRA,4,4,7,15
2014,Winter,Germany,GER,8,6,5,19
2014,Winter,Great Britain,GBR,1,1,3,5
2014,Winter,Italy,ITA,0,2,6,8
2014,Winter,Japan,JPN,1,4,3,8
2014,Winter,Kazakhstan,KAZ,0,0,1,1
2014,Winter,Latvia,LAT,1,1,3,5
2014,Winter,Netherlands,NED,8,7,9,24
2014,Winter,Norway,NOR,11,5,10,26
2014,Winter,Poland,POL,4,1,1,6
2014,Winter,Russia*,RUS,11,10,9,30
2014,Winter,Slovakia,SVK,1,0,0,1
2014,Winter,Slovenia,SLO,2,2,4,8
2014,Winter,South Korea,KOR,3,3,2,8
2014,Winter,Sweden,SWE,2,7,6,15
2014,Winter,Switzerland,SUI,7,2,2,11
2014,Winter,Ukraine,UKR,1,0,1,2
2014,Winter,United States,USA,9,9,10,28
2018,Winter,Australia,AUS,0,2,1,3
2018,Winter,Austria,AUT,5,3,6,14
2018,Winter,Belarus,BLR,2,1,0,3
2018,Winter,Belgium,BEL,0,1,0,1
2018,Winter,Canada,CAN,11,8,10,29
2018,Winter,China,CHN,1,6,2,9
2018,Winter,Czech Republic,CZE,2,2,3,7
2018,Winter,Finland,FIN,1,1,4,6
2018,Winter,France,FRA,5,4,6,15
2018,Winter,Germany,GER,14,10,7,31
2018,Winter,Great Britain,GBR,1,0,4,5
2018,Winter,Hungary,HUN,1,0,0,1
2018,Winter,Italy,ITA,3,2,5,10
2018,Winter,Japan,JPN,4,5,4,13
2018,Winter,Kazakhstan,KAZ,0,0,1,1
2018,Winter,Latvia,LAT,0,0,1,1
2018,Winter,Liechtenstein,LIE,0,0,1,1
2018,Winter,Netherlands,NED,8,6,6,20
2018,Winter,New Zealand,NZL,0,0,2,2
2018,Winter,Norway,NOR,14,14,11,39
2018,Winter,Olympic Athletes from Russia,OAR,2,6,9,17
2018,Winter,Poland,POL,1,0,1,2
2018,Winter,Slovakia,SVK,1,2,0,3
2018,Winter,Slovenia,SLO,0,1,1,2
2018,Winter,South Korea*,KOR,5,8,4,17
2018,Winter,Spain,ESP,0,0,2,2
2018,Winter,Sweden,SWE,7,6,1,14
2018,Winter,Switzerland,SUI,5,6,4,15
2018,Winter,Ukraine,UKR,1,0,0,1
2018,Winter,United States,USA,9,8,6,23
