Primary Key,Year,Season,Nation,NOC Code,Gold,Silver,Bronze,Total
1,2008,Summer,Afghanistan,AFG,0,0,1,1
2,2012,Summer,Afghanistan,AFG,0,0,1,1
3,1984,Summer,Algeria,ALG,0,0,2,2
4,1992,Summer,Algeria,ALG,1,0,1,2
5,1996,Summer,Algeria,ALG,2,0,1,3
6,2000,Summer,Algeria,ALG,1,1,3,5
7,2008,Summer,Algeria,ALG,0,1,1,2
8,2012,Summer,Algeria,ALG,1,0,0,1
9,2016,Summer,Algeria,ALG,0,2,0,2
10,1964,Summer,Argentina,ARG,0,1,0,1
11,1968,Summer,Argentina,ARG,0,0,2,2
12,1972,Summer,Argentina,ARG,0,1,0,1
13,1988,Summer,Argentina,ARG,0,1,1,2
14,1992,Summer,Argentina,ARG,0,0,1,1
15,1996,Summer,Argentina,ARG,0,2,1,3
16,2000,Summer,Argentina,ARG,0,2,2,4
17,2004,Summer,Argentina,ARG,2,0,4,6
18,2008,Summer,Argentina,ARG,2,0,4,6
19,2012,Summer,Argentina,ARG,1,1,2,4
20,2016,Summer,Argentina,ARG,3,1,0,4
21,1960,Summer,Argentina,ARG,0,1,1,2
22,2020,Summer,Argentina,ARG,0,1,2,3
23,1996,Summer,Armenia,ARM,1,1,0,2
24,2000,Summer,Armenia,ARM,0,0,1,1
25,2008,Summer,Armenia,ARM,0,1,4,5
26,2012,Summer,Armenia,ARM,0,1,1,2
27,2016,Summer,Armenia,ARM,1,3,0,4
28,2020,Summer,Armenia,ARM,0,2,2,4
29,1964,Summer,Australia,AUS,6,2,10,18
30,1968,Summer,Australia,AUS,5,7,5,17
31,1972,Summer,Australia,AUS,8,7,2,17
32,1976,Summer,Australia,AUS,0,1,4,5
33,1980,Summer,Australia,AUS,2,2,5,9
34,1984,Summer,Australia,AUS,4,8,12,24
35,1988,Summer,Australia,AUS,3,6,5,14
36,1992,Summer,Australia,AUS,7,9,11,27
37,1996,Summer,Australia,AUS,9,9,23,41
38,2004,Summer,Australia,AUS,17,16,17,50
39,2008,Summer,Australia,AUS,14,15,17,46
40,2012,Summer,Australia,AUS,8,15,12,35
41,2016,Summer,Australia,AUS,8,11,10,29
42,1960,Summer,Australia,AUS,8,8,6,22
43,2020,Summer,Australia,AUS,17,7,22,46
44,2000,Summer,Australia*,AUS,16,25,17,58
45,1968,Summer,Austria,AUT,0,2,2,4
46,1972,Summer,Austria,AUT,0,1,2,3
47,1976,Summer,Austria,AUT,0,0,1,1
48,1980,Summer,Austria,AUT,1,2,1,4
49,1984,Summer,Austria,AUT,1,1,1,3
50,1988,Summer,Austria,AUT,1,0,0,1
51,1992,Summer,Austria,AUT,0,2,0,2
52,1996,Summer,Austria,AUT,0,1,2,3
53,2000,Summer,Austria,AUT,2,1,0,3
54,2004,Summer,Austria,AUT,2,4,1,7
55,2008,Summer,Austria,AUT,0,1,2,3
56,2016,Summer,Austria,AUT,0,0,1,1
57,1960,Summer,Austria,AUT,1,1,0,2
58,2020,Summer,Austria,AUT,1,1,5,7
59,1996,Summer,Azerbaijan,AZE,0,1,0,1
60,2000,Summer,Azerbaijan,AZE,2,0,1,3
61,2004,Summer,Azerbaijan,AZE,1,0,4,5
62,2008,Summer,Azerbaijan,AZE,1,1,4,6
63,2012,Summer,Azerbaijan,AZE,2,2,5,9
64,2016,Summer,Azerbaijan,AZE,1,7,10,18
65,2020,Summer,Azerbaijan,AZE,0,3,4,7
66,1964,Summer,Bahamas,BAH,1,0,0,1
67,1992,Summer,Bahamas,BAH,0,0,1,1
68,1996,Summer,Bahamas,BAH,0,1,0,1
69,2000,Summer,Bahamas,BAH,2,0,1,3
70,2004,Summer,Bahamas,BAH,1,0,1,2
71,2008,Summer,Bahamas,BAH,0,1,1,2
72,2012,Summer,Bahamas,BAH,1,0,0,1
73,2016,Summer,Bahamas,BAH,1,0,1,2
74,2020,Summer,Bahamas,BAH,2,0,0,2
75,2012,Summer,Bahrain,BRN,1,0,0,1
76,2016,Summer,Bahrain,BRN,1,1,0,2
77,2020,Summer,Bahrain,BRN,0,1,0,1
78,2000,Summer,Barbados,BAR,0,0,1,1
79,1996,Summer,Belarus,BLR,1,6,8,15
80,2000,Summer,Belarus,BLR,3,3,11,17
81,2004,Summer,Belarus,BLR,2,5,6,13
82,2008,Summer,Belarus,BLR,3,4,7,14
83,2012,Summer,Belarus,BLR,2,5,3,10
84,2016,Summer,Belarus,BLR,1,4,4,9
85,2020,Summer,Belarus,BLR,1,3,3,7
86,1964,Summer,Belgium,BEL,2,0,1,3
87,1968,Summer,Belgium,BEL,0,1,1,2
88,1972,Summer,Belgium,BEL,0,2,0,2
89,1976,Summer,Belgium,BEL,0,3,3,6
90,1980,Summer,Belgium,BEL,1,0,0,1
91,1984,Summer,Belgium,BEL,1,1,2,4
92,1988,Summer,Belgium,BEL,0,0,2,2
93,1992,Summer,Belgium,BEL,0,1,2,3
94,1996,Summer,Belgium,BEL,2,2,2,6
95,2000,Summer,Belgium,BEL,0,2,3,5
96,2004,Summer,Belgium,BEL,1,0,2,3
97,2008,Summer,Belgium,BEL,2,0,0,2
98,2012,Summer,Belgium,BEL,0,1,2,3
99,2016,Summer,Belgium,BEL,2,2,2,6
100,1960,Summer,Belgium,BEL,0,2,2,4
101,2020,Summer,Belgium,BEL,3,1,3,7
102,1976,Summer,Bermuda,BER,0,0,1,1
103,2020,Summer,Bermuda,BER,1,0,0,1
104,2012,Summer,Botswana,BOT,0,1,0,1
105,2020,Summer,Botswana,BOT,0,0,1,1
106,1964,Summer,Brazil,BRA,0,0,1,1
107,1968,Summer,Brazil,BRA,0,1,2,3
108,1972,Summer,Brazil,BRA,0,0,2,2
109,1976,Summer,Brazil,BRA,0,0,2,2
110,1980,Summer,Brazil,BRA,2,0,2,4
111,1984,Summer,Brazil,BRA,1,5,2,8
112,1988,Summer,Brazil,BRA,1,2,3,6
113,1992,Summer,Brazil,BRA,2,1,0,3
114,1996,Summer,Brazil,BRA,3,3,9,15
115,2000,Summer,Brazil,BRA,0,6,6,12
116,2004,Summer,Brazil,BRA,5,2,3,10
117,2008,Summer,Brazil,BRA,3,4,10,17
118,2012,Summer,Brazil,BRA,3,5,9,17
119,1960,Summer,Brazil,BRA,0,0,2,2
120,2020,Summer,Brazil,BRA,7,6,8,21
121,2016,Summer,Brazil,BRA,7,6,6,19
122,1960,Summer,British West Indies ,BWI,0,0,2,2
123,1964,Summer,Bulgaria,BUL,3,5,2,10
124,1968,Summer,Bulgaria,BUL,2,4,3,9
125,1972,Summer,Bulgaria,BUL,6,10,5,21
126,1976,Summer,Bulgaria,BUL,6,9,7,22
127,1980,Summer,Bulgaria,BUL,8,16,17,41
128,1988,Summer,Bulgaria,BUL,10,12,13,35
129,1992,Summer,Bulgaria,BUL,3,7,6,16
130,1996,Summer,Bulgaria,BUL,3,7,5,15
131,2000,Summer,Bulgaria,BUL,5,6,2,13
132,2004,Summer,Bulgaria,BUL,2,1,9,12
133,2008,Summer,Bulgaria,BUL,1,1,3,5
134,2012,Summer,Bulgaria,BUL,0,2,1,3
135,2016,Summer,Bulgaria,BUL,0,1,2,3
136,1960,Summer,Bulgaria,BUL,1,3,3,7
137,2020,Summer,Bulgaria,BUL,3,1,2,6
138,2020,Summer,Burkina Faso ,BUR,0,0,1,1
139,1996,Summer,Burundi,BDI,1,0,0,1
140,2016,Summer,Burundi,BDI,0,1,0,1
141,1968,Summer,Cameroon,CMR,0,1,0,1
142,1984,Summer,Cameroon,CMR,0,0,1,1
143,2000,Summer,Cameroon,CMR,1,0,0,1
144,2004,Summer,Cameroon,CMR,1,0,0,1
145,2008,Summer,Cameroon,CMR,1,0,0,1
146,2012,Summer,Cameroon,CMR,0,0,1,1
147,1964,Summer,Canada,CAN,1,2,1,4
148,1968,Summer,Canada,CAN,1,3,1,5
149,1972,Summer,Canada,CAN,0,2,3,5
150,1984,Summer,Canada,CAN,10,18,16,44
151,1988,Summer,Canada,CAN,3,2,5,10
152,1992,Summer,Canada,CAN,7,4,7,18
153,1996,Summer,Canada,CAN,3,11,8,22
154,2000,Summer,Canada,CAN,3,3,8,14
155,2004,Summer,Canada,CAN,3,6,3,12
156,2008,Summer,Canada,CAN,3,9,8,20
157,2012,Summer,Canada,CAN,2,6,10,18
158,2016,Summer,Canada,CAN,4,3,15,22
159,1960,Summer,Canada,CAN,0,1,0,1
160,2020,Summer,Canada,CAN,7,6,11,24
161,1976,Summer,Canada*,CAN,0,5,6,11
162,1988,Summer,Chile,CHI,0,1,0,1
163,2000,Summer,Chile,CHI,0,0,1,1
164,2004,Summer,Chile,CHI,2,0,1,3
165,2008,Summer,Chile,CHI,0,1,0,1
166,1984,Summer,China,CHN,15,8,9,32
167,1988,Summer,China,CHN,5,11,12,28
168,1992,Summer,China,CHN,16,22,16,54
169,1996,Summer,China,CHN,16,22,12,50
170,2000,Summer,China,CHN,28,16,14,58
171,2004,Summer,China,CHN,32,17,14,63
172,2012,Summer,China,CHN,38,31,22,91
173,2016,Summer,China,CHN,26,18,26,70
174,2020,Summer,China,CHN,38,32,18,88
175,2008,Summer,China*,CHN,48,22,30,100
176,1984,Summer,Chinese Taipei,TPE,0,0,1,1
177,1992,Summer,Chinese Taipei,TPE,0,1,0,1
178,1996,Summer,Chinese Taipei,TPE,0,1,0,1
179,2000,Summer,Chinese Taipei,TPE,0,1,4,5
180,2004,Summer,Chinese Taipei,TPE,2,2,1,5
181,2008,Summer,Chinese Taipei,TPE,1,1,2,4
182,2012,Summer,Chinese Taipei,TPE,1,0,1,2
183,2016,Summer,Chinese Taipei,TPE,1,0,2,3
184,2020,Summer,Chinese Taipei,TPE,2,4,6,12
185,1972,Summer,Colombia,COL,0,1,2,3
186,1984,Summer,Colombia,COL,0,1,0,1
187,1988,Summer,Colombia,COL,0,0,1,1
188,1992,Summer,Colombia,COL,0,0,1,1
189,2000,Summer,Colombia,COL,1,0,0,1
190,2004,Summer,Colombia,COL,0,0,2,2
191,2008,Summer,Colombia,COL,0,2,1,3
192,2012,Summer,Colombia,COL,1,3,5,9
193,2016,Summer,Colombia,COL,3,2,3,8
194,2020,Summer,Colombia,COL,0,4,1,5
195,1988,Summer,Costa Rica,CRC,0,1,0,1
196,1996,Summer,Costa Rica,CRC,1,0,0,1
197,2000,Summer,Costa Rica,CRC,0,0,2,2
198,1992,Summer,Croatia,CRO,0,1,2,3
199,1996,Summer,Croatia,CRO,1,1,0,2
200,2000,Summer,Croatia,CRO,1,0,1,2
201,2004,Summer,Croatia,CRO,1,2,2,5
202,2008,Summer,Croatia,CRO,0,2,3,5
203,2012,Summer,Croatia,CRO,3,1,2,6
204,2016,Summer,Croatia,CRO,5,3,2,10
205,2020,Summer,Croatia,CRO,3,3,2,8
206,1964,Summer,Cuba,CUB,0,1,0,1
207,1968,Summer,Cuba,CUB,0,4,0,4
208,1972,Summer,Cuba,CUB,3,1,4,8
209,1976,Summer,Cuba,CUB,6,4,3,13
210,1980,Summer,Cuba,CUB,8,7,5,20
211,1992,Summer,Cuba,CUB,14,6,11,31
212,1996,Summer,Cuba,CUB,9,8,8,25
213,2000,Summer,Cuba,CUB,11,11,7,29
214,2004,Summer,Cuba,CUB,9,7,11,27
215,2008,Summer,Cuba,CUB,3,10,17,30
216,2012,Summer,Cuba,CUB,5,3,7,15
217,2016,Summer,Cuba,CUB,5,2,4,11
218,2020,Summer,Cuba,CUB,7,3,5,15
219,2012,Summer,Cyprus,CYP,0,1,0,1
220,1996,Summer,Czech Republic,CZE,4,3,4,11
221,2000,Summer,Czech Republic,CZE,2,3,3,8
222,2004,Summer,Czech Republic,CZE,1,3,5,9
223,2008,Summer,Czech Republic,CZE,3,3,1,7
224,2012,Summer,Czech Republic,CZE,4,3,4,11
225,2016,Summer,Czech Republic,CZE,1,2,7,10
226,2020,Summer,Czech Republic ,CZE,4,4,3,11
227,1964,Summer,Czechoslovakia,TCH,5,6,3,14
228,1968,Summer,Czechoslovakia,TCH,7,2,4,13
229,1972,Summer,Czechoslovakia,TCH,2,4,2,8
230,1976,Summer,Czechoslovakia,TCH,2,2,4,8
231,1980,Summer,Czechoslovakia,TCH,2,3,9,14
232,1988,Summer,Czechoslovakia,TCH,3,3,2,8
233,1992,Summer,Czechoslovakia,TCH,4,2,1,7
234,1960,Summer,Czechoslovakia ,TCH,3,2,3,8
235,1964,Summer,Denmark,DEN,2,1,3,6
236,1968,Summer,Denmark,DEN,1,4,3,8
237,1972,Summer,Denmark,DEN,1,0,0,1
238,1976,Summer,Denmark,DEN,1,0,2,3
239,1980,Summer,Denmark,DEN,2,1,2,5
240,1984,Summer,Denmark,DEN,0,3,3,6
241,1988,Summer,Denmark,DEN,2,1,1,4
242,1992,Summer,Denmark,DEN,1,1,4,6
243,1996,Summer,Denmark,DEN,4,1,1,6
244,2000,Summer,Denmark,DEN,2,3,1,6
245,2004,Summer,Denmark,DEN,2,1,5,8
246,2008,Summer,Denmark,DEN,2,2,3,7
247,2012,Summer,Denmark,DEN,2,4,3,9
248,2016,Summer,Denmark,DEN,2,6,7,15
249,1960,Summer,Denmark,DEN,2,3,1,6
250,2020,Summer,Denmark,DEN,3,4,4,11
251,1988,Summer,Djibouti,DJI,0,0,1,1
252,1984,Summer,Dominican Republic,DOM,0,0,1,1
253,2004,Summer,Dominican Republic,DOM,1,0,0,1
254,2008,Summer,Dominican Republic,DOM,1,1,0,2
255,2012,Summer,Dominican Republic,DOM,1,1,0,2
256,2016,Summer,Dominican Republic,DOM,0,0,1,1
257,2020,Summer,Dominican Republic,DOM,0,3,2,5
258,1968,Summer,East Germany,GDR,9,9,7,25
259,1972,Summer,East Germany,GDR,20,23,23,66
260,1976,Summer,East Germany,GDR,40,25,25,90
261,1980,Summer,East Germany,GDR,47,37,42,126
262,1988,Summer,East Germany,GDR,37,35,30,102
263,1996,Summer,Ecuador,ECU,1,0,0,1
264,2008,Summer,Ecuador,ECU,0,1,0,1
265,2020,Summer,Ecuador,ECU,2,1,0,3
266,1984,Summer,Egypt,EGY,0,1,0,1
267,2004,Summer,Egypt,EGY,1,1,3,5
268,2008,Summer,Egypt,EGY,0,0,2,2
269,2012,Summer,Egypt,EGY,0,3,1,4
270,2016,Summer,Egypt,EGY,0,0,3,3
271,1960,Summer,Egypt,EGY,0,1,1,2
272,2020,Summer,Egypt,EGY,1,1,4,6
273,2004,Summer,Eritrea,ERI,0,0,1,1
274,1992,Summer,Estonia,EST,1,0,1,2
275,2000,Summer,Estonia,EST,1,0,2,3
276,2004,Summer,Estonia,EST,0,1,2,3
277,2008,Summer,Estonia,EST,1,1,0,2
278,2012,Summer,Estonia,EST,0,1,1,2
279,2016,Summer,Estonia,EST,0,0,1,1
280,2020,Summer,Estonia,EST,1,0,1,2
281,1964,Summer,Ethiopia,ETH,1,0,0,1
282,1968,Summer,Ethiopia,ETH,1,1,0,2
283,1972,Summer,Ethiopia,ETH,0,0,2,2
284,1980,Summer,Ethiopia,ETH,2,0,2,4
285,1992,Summer,Ethiopia,ETH,1,0,2,3
286,1996,Summer,Ethiopia,ETH,2,0,1,3
287,2000,Summer,Ethiopia,ETH,4,1,3,8
288,2004,Summer,Ethiopia,ETH,2,3,2,7
289,2008,Summer,Ethiopia,ETH,4,2,1,7
290,2012,Summer,Ethiopia,ETH,3,2,3,8
291,2016,Summer,Ethiopia,ETH,1,2,5,8
292,1960,Summer,Ethiopia,ETH,1,0,0,1
293,2020,Summer,Ethiopia,ETH,1,1,2,4
294,2016,Summer,Fiji,FIJ,1,0,0,1
295,2020,Summer,Fiji,FIJ,1,0,1,2
296,1964,Summer,Finland,FIN,3,0,2,5
297,1968,Summer,Finland,FIN,1,2,1,4
298,1972,Summer,Finland,FIN,3,1,4,8
299,1976,Summer,Finland,FIN,4,2,0,6
300,1980,Summer,Finland,FIN,3,1,4,8
301,1984,Summer,Finland,FIN,4,2,6,12
302,1988,Summer,Finland,FIN,1,1,2,4
303,1992,Summer,Finland,FIN,1,2,2,5
304,1996,Summer,Finland,FIN,1,2,1,4
305,2000,Summer,Finland,FIN,2,1,1,4
306,2004,Summer,Finland,FIN,0,2,0,2
307,2008,Summer,Finland,FIN,1,1,2,4
308,2012,Summer,Finland,FIN,0,2,1,3
309,2016,Summer,Finland,FIN,0,0,1,1
310,1960,Summer,Finland,FIN,1,1,3,5
311,2020,Summer,Finland,FIN,0,0,2,2
312,1960,Summer,Formosa ,RCF,0,1,0,1
313,1996,Summer,Yugoslavia,YUG,1,1,2,4
314,2000,Summer,Yugoslavia,YUG,1,1,1,3
315,1964,Summer,France,FRA,1,8,6,15
316,1968,Summer,France,FRA,7,3,5,15
317,1972,Summer,France,FRA,2,4,7,13
318,1976,Summer,France,FRA,2,3,4,9
319,1980,Summer,France,FRA,6,5,3,14
320,1984,Summer,France,FRA,5,7,16,28
321,1988,Summer,France,FRA,6,4,6,16
322,1992,Summer,France,FRA,8,5,16,29
323,1996,Summer,France,FRA,15,7,15,37
324,2000,Summer,France,FRA,13,14,11,38
325,2004,Summer,France,FRA,11,9,13,33
326,2008,Summer,France,FRA,7,16,20,43
327,2012,Summer,France,FRA,11,11,13,35
328,2016,Summer,France,FRA,10,18,14,42
329,1960,Summer,France,FRA,0,2,3,5
330,2020,Summer,France,FRA,10,12,11,33
331,2012,Summer,Gabon,GAB,0,1,0,1
332,1996,Summer,Georgia,GEO,0,0,2,2
333,2000,Summer,Georgia,GEO,0,0,6,6
334,2004,Summer,Georgia,GEO,2,2,0,4
335,2008,Summer,Georgia,GEO,3,2,2,7
336,2012,Summer,Georgia,GEO,1,2,3,6
337,2016,Summer,Georgia,GEO,2,1,4,7
338,2020,Summer,Georgia ,GEO,2,5,1,8
339,1992,Summer,Germany,GER,33,21,28,82
340,1996,Summer,Germany,GER,20,18,27,65
341,2000,Summer,Germany,GER,13,17,26,56
342,2004,Summer,Germany,GER,13,16,20,49
343,2008,Summer,Germany,GER,16,11,14,41
344,2012,Summer,Germany,GER,11,20,13,44
345,2016,Summer,Germany,GER,17,10,15,42
346,2020,Summer,Germany,GER,10,11,16,37
347,1964,Summer,Ghana,GHA,0,0,1,1
348,1972,Summer,Ghana,GHA,0,0,1,1
349,1992,Summer,Ghana,GHA,0,0,1,1
350,1960,Summer,Ghana,GHA,0,1,0,1
351,2020,Summer,Ghana,GHA,0,0,1,1
352,1964,Summer,Great Britain,GBR,4,12,2,18
353,1968,Summer,Great Britain,GBR,5,5,3,13
354,1972,Summer,Great Britain,GBR,4,5,9,18
355,1976,Summer,Great Britain,GBR,3,5,5,13
356,1980,Summer,Great Britain,GBR,5,7,9,21
357,1984,Summer,Great Britain,GBR,5,11,21,37
358,1988,Summer,Great Britain,GBR,5,10,9,24
359,1992,Summer,Great Britain,GBR,5,3,12,20
360,1996,Summer,Great Britain,GBR,1,8,6,15
361,2000,Summer,Great Britain,GBR,11,10,7,28
362,2004,Summer,Great Britain,GBR,9,9,12,30
363,2008,Summer,Great Britain,GBR,19,13,19,51
364,2016,Summer,Great Britain,GBR,27,23,17,67
365,1960,Summer,Great Britain,GBR,2,6,12,20
366,2020,Summer,Great Britain,GBR,22,21,22,65
367,2012,Summer,Great Britain*,GBR,29,18,18,65
368,1968,Summer,Greece,GRE,0,0,1,1
369,1972,Summer,Greece,GRE,0,2,0,2
370,1980,Summer,Greece,GRE,1,0,2,3
371,1984,Summer,Greece,GRE,0,1,1,2
372,1988,Summer,Greece,GRE,0,0,1,1
373,1992,Summer,Greece,GRE,2,0,0,2
374,1996,Summer,Greece,GRE,4,4,0,8
375,2000,Summer,Greece,GRE,4,6,3,13
376,2008,Summer,Greece,GRE,0,2,1,3
377,2012,Summer,Greece,GRE,0,0,2,2
378,2016,Summer,Greece,GRE,3,1,2,6
379,1960,Summer,Greece,GRE,1,0,0,1
380,2020,Summer,Greece,GRE,2,1,1,4
381,2004,Summer,Greece*,GRE,6,6,4,16
382,2012,Summer,Grenada,GRN,1,0,0,1
383,2016,Summer,Grenada,GRN,0,1,0,1
384,2020,Summer,Grenada,GRN,0,0,1,1
385,2012,Summer,Guatemala,GUA,0,1,0,1
386,1980,Summer,Guyana,GUY,0,0,1,1
387,1996,Summer,Hong Kong,HKG,1,0,0,1
388,2004,Summer,Hong Kong,HKG,0,1,0,1
389,2012,Summer,Hong Kong,HKG,0,0,1,1
390,2020,Summer,Hong Kong ,HKG,1,2,3,6
391,1964,Summer,Hungary,HUN,10,7,5,22
392,1968,Summer,Hungary,HUN,10,10,12,32
393,1972,Summer,Hungary,HUN,6,13,16,35
394,1976,Summer,Hungary,HUN,4,5,13,22
395,1980,Summer,Hungary,HUN,7,10,15,32
396,1988,Summer,Hungary,HUN,11,6,6,23
397,1992,Summer,Hungary,HUN,11,12,7,30
398,1996,Summer,Hungary,HUN,7,4,10,21
399,2000,Summer,Hungary,HUN,8,6,3,17
400,2004,Summer,Hungary,HUN,8,6,3,17
401,2008,Summer,Hungary,HUN,3,5,2,10
402,2012,Summer,Hungary,HUN,8,4,6,18
403,2016,Summer,Hungary,HUN,8,3,4,15
404,1960,Summer,Hungary,HUN,6,8,7,21
405,2020,Summer,Hungary,HUN,6,7,7,20
406,1984,Summer,Iceland,ISL,0,0,1,1
407,2000,Summer,Iceland,ISL,0,0,1,1
408,2008,Summer,Iceland,ISL,0,1,0,1
409,2016,Summer,Independent Olympic Athletes,IOA,1,0,1,2
410,1992,Summer,Independent Olympic Participants,IOP,0,1,2,3
411,1964,Summer,India,IND,1,0,0,1
412,1968,Summer,India,IND,0,0,1,1
413,1972,Summer,India,IND,0,0,1,1
414,1980,Summer,India,IND,1,0,0,1
415,1996,Summer,India,IND,0,0,1,1
416,2000,Summer,India,IND,0,0,1,1
417,2004,Summer,India,IND,0,1,0,1
418,2008,Summer,India,IND,1,0,2,3
419,2012,Summer,India,IND,0,2,4,6
420,2016,Summer,India,IND,0,1,1,2
421,1960,Summer,India,IND,0,1,0,1
422,2020,Summer,India,IND,1,2,4,7
423,1988,Summer,Indonesia,INA,0,1,0,1
424,1992,Summer,Indonesia,INA,2,2,1,5
425,1996,Summer,Indonesia,INA,1,1,2,4
426,2000,Summer,Indonesia,INA,1,3,2,6
427,2004,Summer,Indonesia,INA,1,1,2,4
428,2008,Summer,Indonesia,INA,1,1,4,6
429,2012,Summer,Indonesia,INA,0,2,1,3
430,2016,Summer,Indonesia,INA,1,2,0,3
431,2020,Summer,Indonesia,INA,1,1,3,5
432,1964,Summer,Iran,IRI,0,0,2,2
433,1968,Summer,Iran,IRI,2,1,2,5
434,1972,Summer,Iran,IRI,0,2,1,3
435,1976,Summer,Iran,IRI,0,1,1,2
436,1988,Summer,Iran,IRI,0,1,0,1
437,1992,Summer,Iran,IRI,0,1,2,3
438,1996,Summer,Iran,IRI,1,1,1,3
439,2000,Summer,Iran,IRI,3,0,1,4
440,2004,Summer,Iran,IRI,2,2,2,6
441,2008,Summer,Iran,IRI,1,0,1,2
442,2012,Summer,Iran,IRI,7,5,1,13
443,2016,Summer,Iran,IRI,3,1,4,8
444,1960,Summer,Iran,IRI,0,1,3,4
445,2020,Summer,Iran,IRI,3,2,2,7
446,1960,Summer,Iraq ,IRQ,0,0,1,1
447,1964,Summer,Ireland,IRL,0,0,1,1
448,1980,Summer,Ireland,IRL,0,1,1,2
449,1984,Summer,Ireland,IRL,0,1,0,1
450,1992,Summer,Ireland,IRL,1,1,0,2
451,1996,Summer,Ireland,IRL,3,0,1,4
452,2000,Summer,Ireland,IRL,0,1,0,1
453,2008,Summer,Ireland,IRL,0,1,2,3
454,2012,Summer,Ireland,IRL,1,1,4,6
455,2016,Summer,Ireland,IRL,0,2,0,2
456,2020,Summer,Ireland,IRL,2,0,2,4
457,1992,Summer,Israel,ISR,0,1,1,2
458,1996,Summer,Israel,ISR,0,0,1,1
459,2000,Summer,Israel,ISR,0,0,1,1
460,2004,Summer,Israel,ISR,1,0,1,2
461,2008,Summer,Israel,ISR,0,0,1,1
462,2016,Summer,Israel,ISR,0,0,2,2
463,2020,Summer,Israel,ISR,2,0,2,4
464,1964,Summer,Italy,ITA,10,10,7,27
465,1968,Summer,Italy,ITA,3,4,9,16
466,1972,Summer,Italy,ITA,5,3,10,18
467,1976,Summer,Italy,ITA,2,7,4,13
468,1980,Summer,Italy,ITA,8,3,4,15
469,1984,Summer,Italy,ITA,14,6,12,32
470,1988,Summer,Italy,ITA,6,4,4,14
471,1992,Summer,Italy,ITA,6,5,8,19
472,1996,Summer,Italy,ITA,13,10,12,35
473,2000,Summer,Italy,ITA,13,8,13,34
474,2004,Summer,Italy,ITA,10,11,11,32
475,2008,Summer,Italy,ITA,8,9,10,27
476,2012,Summer,Italy,ITA,8,9,11,28
477,2016,Summer,Italy,ITA,8,12,8,28
478,1960,Summer,Italy,ITA,13,10,13,36
479,2020,Summer,Italy,ITA,10,10,20,40
480,1984,Summer,Ivory Coast,CIV,0,1,0,1
481,2016,Summer,Ivory Coast,CIV,1,0,1,2
482,2020,Summer,Ivory Coast,CIV,0,0,1,1
483,1968,Summer,Jamaica,JAM,0,1,0,1
484,1972,Summer,Jamaica,JAM,0,0,1,1
485,1976,Summer,Jamaica,JAM,1,1,0,2
486,1980,Summer,Jamaica,JAM,0,0,3,3
487,1984,Summer,Jamaica,JAM,0,1,2,3
488,1988,Summer,Jamaica,JAM,0,2,0,2
489,1992,Summer,Jamaica,JAM,0,3,1,4
490,1996,Summer,Jamaica,JAM,1,3,2,6
491,2000,Summer,Jamaica,JAM,0,6,3,9
492,2004,Summer,Jamaica,JAM,2,1,2,5
493,2008,Summer,Jamaica,JAM,5,4,2,11
494,2012,Summer,Jamaica,JAM,4,5,3,12
495,2016,Summer,Jamaica,JAM,6,3,2,11
496,2020,Summer,Jamaica,JAM,4,1,4,9
497,1968,Summer,Japan,JPN,11,7,7,25
498,1972,Summer,Japan,JPN,13,8,8,29
499,1976,Summer,Japan,JPN,9,6,10,25
500,1984,Summer,Japan,JPN,10,8,14,32
501,1988,Summer,Japan,JPN,4,3,7,14
502,1992,Summer,Japan,JPN,3,8,11,22
503,1996,Summer,Japan,JPN,3,6,5,14
504,2000,Summer,Japan,JPN,5,8,5,18
505,2004,Summer,Japan,JPN,16,9,12,37
506,2008,Summer,Japan,JPN,9,8,8,25
507,2012,Summer,Japan,JPN,7,14,17,38
508,2016,Summer,Japan,JPN,12,8,21,41
509,1960,Summer,Japan,JPN,4,7,7,18
510,2020,Summer,Japan,JPN,27,14,17,58
511,1964,Summer,Japan*,JPN,16,5,8,29
512,2016,Summer,Jordan,JOR,1,0,0,1
513,2020,Summer,Jordan,JOR,0,1,1,2
514,1996,Summer,Kazakhstan,KAZ,3,4,4,11
515,2000,Summer,Kazakhstan,KAZ,3,4,0,7
516,2004,Summer,Kazakhstan,KAZ,1,4,3,8
517,2008,Summer,Kazakhstan,KAZ,2,3,4,9
518,2012,Summer,Kazakhstan,KAZ,3,2,6,11
519,2016,Summer,Kazakhstan,KAZ,3,5,10,18
520,2020,Summer,Kazakhstan,KAZ,0,0,8,8
521,1964,Summer,Kenya,KEN,0,0,1,1
522,1968,Summer,Kenya,KEN,3,4,2,9
523,1972,Summer,Kenya,KEN,2,3,4,9
524,1984,Summer,Kenya,KEN,1,0,2,3
525,1988,Summer,Kenya,KEN,5,2,2,9
526,1992,Summer,Kenya,KEN,2,4,2,8
527,1996,Summer,Kenya,KEN,1,4,3,8
528,2000,Summer,Kenya,KEN,2,3,2,7
529,2004,Summer,Kenya,KEN,1,4,2,7
530,2008,Summer,Kenya,KEN,6,4,6,16
531,2012,Summer,Kenya,KEN,2,4,7,13
532,2016,Summer,Kenya,KEN,6,6,1,13
533,2020,Summer,Kenya,KEN,4,4,2,10
534,2016,Summer,Kosovo,KOS,1,0,0,1
535,2020,Summer,Kosovo,KOS,2,0,0,2
536,2000,Summer,Kuwait,KUW,0,0,1,1
537,2012,Summer,Kuwait,KUW,0,0,1,1
538,2020,Summer,Kuwait,KUW,0,0,1,1
539,2000,Summer,Kyrgyzstan,KGZ,0,0,1,1
540,2008,Summer,Kyrgyzstan,KGZ,0,1,2,3
541,2020,Summer,Kyrgyzstan,KGZ,0,2,1,3
542,1992,Summer,Latvia,LAT,0,2,1,3
543,1996,Summer,Latvia,LAT,0,1,0,1
544,2000,Summer,Latvia,LAT,1,1,1,3
545,2004,Summer,Latvia,LAT,0,4,0,4
546,2008,Summer,Latvia,LAT,1,1,1,3
547,2012,Summer,Latvia,LAT,1,0,1,2
548,2020,Summer,Latvia,LAT,1,0,1,2
549,1972,Summer,Lebanon,LBN,0,1,0,1
550,1980,Summer,Lebanon,LBN,0,0,1,1
551,1992,Summer,Lithuania,LTU,1,0,1,2
552,1996,Summer,Lithuania,LTU,0,0,1,1
553,2000,Summer,Lithuania,LTU,2,0,3,5
554,2004,Summer,Lithuania,LTU,1,2,0,3
555,2008,Summer,Lithuania,LTU,0,3,2,5
556,2012,Summer,Lithuania,LTU,2,0,3,5
557,2016,Summer,Lithuania,LTU,0,1,3,4
558,2020,Summer,Lithuania,LTU,0,1,0,1
559,2000,Summer,Macedonia,MKD,0,0,1,1
560,1992,Summer,Malaysia,MAS,0,0,1,1
561,1996,Summer,Malaysia,MAS,0,1,1,2
562,2008,Summer,Malaysia,MAS,0,1,0,1
563,2012,Summer,Malaysia,MAS,0,1,1,2
564,2016,Summer,Malaysia,MAS,0,4,1,5
565,2020,Summer,Malaysia,MAS,0,1,1,2
566,2008,Summer,Mauritius,MRI,0,0,1,1
567,1964,Summer,Mexico,MEX,0,0,1,1
568,1972,Summer,Mexico,MEX,0,1,0,1
569,1976,Summer,Mexico,MEX,1,0,1,2
570,1980,Summer,Mexico,MEX,0,1,3,4
571,1984,Summer,Mexico,MEX,2,3,1,6
572,1988,Summer,Mexico,MEX,0,0,2,2
573,1992,Summer,Mexico,MEX,0,1,0,1
574,1996,Summer,Mexico,MEX,0,0,1,1
575,2000,Summer,Mexico,MEX,1,2,3,6
576,2004,Summer,Mexico,MEX,0,3,1,4
577,2008,Summer,Mexico,MEX,2,0,2,4
578,2012,Summer,Mexico,MEX,1,3,4,8
579,2016,Summer,Mexico,MEX,0,3,2,5
580,1960,Summer,Mexico,MEX,0,0,1,1
581,2020,Summer,Mexico,MEX,0,0,4,4
582,1968,Summer,Mexico*,MEX,3,3,3,9
583,1996,Summer,Moldova,MDA,0,1,1,2
584,2000,Summer,Moldova,MDA,0,1,1,2
585,2008,Summer,Moldova,MDA,0,0,1,1
586,2020,Summer,Moldova,MDA,0,0,1,1
587,1968,Summer,Mongolia,MGL,0,1,3,4
588,1972,Summer,Mongolia,MGL,0,1,0,1
589,1976,Summer,Mongolia,MGL,0,1,0,1
590,1980,Summer,Mongolia,MGL,0,2,2,4
591,1988,Summer,Mongolia,MGL,0,0,1,1
592,1992,Summer,Mongolia,MGL,0,0,2,2
593,1996,Summer,Mongolia,MGL,0,0,1,1
594,2004,Summer,Mongolia,MGL,0,0,1,1
595,2008,Summer,Mongolia,MGL,2,2,0,4
596,2012,Summer,Mongolia,MGL,0,2,3,5
597,2016,Summer,Mongolia,MGL,0,1,1,2
598,2020,Summer,Mongolia,MGL,0,1,3,4
599,2012,Summer,Montenegro,MNE,0,1,0,1
600,1984,Summer,Morocco,MAR,2,0,0,2
601,1988,Summer,Morocco,MAR,1,0,2,3
602,1992,Summer,Morocco,MAR,1,1,1,3
603,1996,Summer,Morocco,MAR,0,0,2,2
604,2000,Summer,Morocco,MAR,0,1,4,5
605,2004,Summer,Morocco,MAR,2,1,0,3
606,2008,Summer,Morocco,MAR,0,1,1,2
607,2012,Summer,Morocco,MAR,0,0,1,1
608,2016,Summer,Morocco,MAR,0,0,1,1
609,1960,Summer,Morocco,MAR,0,1,0,1
610,2020,Summer,Morocco,MAR,1,0,0,1
611,1996,Summer,Mozambique,MOZ,0,0,1,1
612,2000,Summer,Mozambique,MOZ,1,0,0,1
613,1992,Summer,Namibia,NAM,0,2,0,2
614,1996,Summer,Namibia,NAM,0,2,0,2
615,2020,Summer,Namibia,NAM,0,1,0,1
616,1964,Summer,Netherlands,NED,2,4,4,10
617,1968,Summer,Netherlands,NED,3,3,1,7
618,1972,Summer,Netherlands,NED,3,1,1,5
619,1976,Summer,Netherlands,NED,0,2,3,5
620,1980,Summer,Netherlands,NED,0,1,2,3
621,1984,Summer,Netherlands,NED,5,2,6,13
622,1988,Summer,Netherlands,NED,2,2,5,9
623,1992,Summer,Netherlands,NED,2,6,7,15
624,1996,Summer,Netherlands,NED,4,5,10,19
625,2000,Summer,Netherlands,NED,12,9,4,25
626,2004,Summer,Netherlands,NED,4,9,9,22
627,2008,Summer,Netherlands,NED,7,5,4,16
628,2012,Summer,Netherlands,NED,6,6,8,20
629,2016,Summer,Netherlands,NED,8,7,4,19
630,1988,Summer,Netherlands Antilles,AHO,0,1,0,1
631,1960,Summer,Netherlands,NED,0,1,2,3
632,2020,Summer,Netherlands,NED,10,12,14,36
633,1964,Summer,New Zealand,NZL,3,0,2,5
634,1968,Summer,New Zealand,NZL,1,0,2,3
635,1972,Summer,New Zealand,NZL,1,1,1,3
636,1976,Summer,New Zealand,NZL,2,1,1,4
637,1984,Summer,New Zealand,NZL,8,1,2,11
638,1988,Summer,New Zealand,NZL,3,2,8,13
639,1992,Summer,New Zealand,NZL,1,4,5,10
640,1996,Summer,New Zealand,NZL,3,2,1,6
641,2000,Summer,New Zealand,NZL,1,0,3,4
642,2004,Summer,New Zealand,NZL,3,2,0,5
643,2008,Summer,New Zealand,NZL,3,2,4,9
644,2012,Summer,New Zealand,NZL,6,2,5,13
645,2016,Summer,New Zealand,NZL,4,9,5,18
646,1960,Summer,New Zealand,NZL,2,0,1,3
647,2020,Summer,New Zealand,NZL,7,6,7,20
648,1972,Summer,Niger,NIG,0,0,1,1
649,2016,Summer,Niger,NIG,0,1,0,1
650,1964,Summer,Nigeria,NGR,0,0,1,1
651,1972,Summer,Nigeria,NGR,0,0,1,1
652,1984,Summer,Nigeria,NGR,0,1,1,2
653,1992,Summer,Nigeria,NGR,0,3,1,4
654,1996,Summer,Nigeria,NGR,2,1,3,6
655,2000,Summer,Nigeria,NGR,1,2,0,3
656,2004,Summer,Nigeria,NGR,0,0,2,2
657,2008,Summer,Nigeria,NGR,0,3,2,5
658,2016,Summer,Nigeria,NGR,0,0,1,1
659,2020,Summer,Nigeria,NGR,0,1,1,2
660,1972,Summer,North Korea,PRK,1,1,3,5
661,1976,Summer,North Korea,PRK,1,1,0,2
662,1980,Summer,North Korea,PRK,0,3,2,5
663,1992,Summer,North Korea,PRK,4,0,5,9
664,1996,Summer,North Korea,PRK,2,1,2,5
665,2000,Summer,North Korea,PRK,0,1,3,4
666,2004,Summer,North Korea,PRK,0,4,1,5
667,2008,Summer,North Korea,PRK,2,2,2,6
668,2012,Summer,North Korea,PRK,4,0,3,7
669,2016,Summer,North Korea,PRK,2,3,2,7
670,2020,Summer,North Macedonia,MKD,0,1,0,1
671,1968,Summer,Norway,NOR,1,1,0,2
672,1972,Summer,Norway,NOR,2,1,1,4
673,1976,Summer,Norway,NOR,1,1,0,2
674,1984,Summer,Norway,NOR,0,1,2,3
675,1988,Summer,Norway,NOR,2,3,0,5
676,1992,Summer,Norway,NOR,2,4,1,7
677,1996,Summer,Norway,NOR,2,2,3,7
678,2000,Summer,Norway,NOR,4,3,3,10
679,2004,Summer,Norway,NOR,5,0,1,6
680,2008,Summer,Norway,NOR,3,5,1,9
681,2012,Summer,Norway,NOR,2,1,1,4
682,2016,Summer,Norway,NOR,0,0,4,4
683,1960,Summer,Norway,NOR,1,0,0,1
684,2020,Summer,Norway,NOR,4,2,2,8
685,1964,Summer,Pakistan,PAK,0,1,0,1
686,1968,Summer,Pakistan,PAK,1,0,0,1
687,1972,Summer,Pakistan,PAK,0,1,0,1
688,1976,Summer,Pakistan,PAK,0,0,1,1
689,1984,Summer,Pakistan,PAK,1,0,0,1
690,1988,Summer,Pakistan,PAK,0,0,1,1
691,1992,Summer,Pakistan,PAK,0,0,1,1
692,1960,Summer,Pakistan,PAK,1,0,1,2
693,2008,Summer,Panama,PAN,1,0,0,1
694,2004,Summer,Paraguay,PAR,0,1,0,1
695,1984,Summer,Peru,PER,0,1,0,1
696,1988,Summer,Peru,PER,0,1,0,1
697,1992,Summer,Peru,PER,0,1,0,1
698,1964,Summer,Philippines,PHI,0,1,0,1
699,1988,Summer,Philippines,PHI,0,0,1,1
700,1992,Summer,Philippines,PHI,0,0,1,1
701,1996,Summer,Philippines,PHI,0,1,0,1
702,2016,Summer,Philippines,PHI,0,1,0,1
703,2020,Summer,Philippines,PHI,1,2,1,4
704,1964,Summer,Poland,POL,7,6,10,23
705,1968,Summer,Poland,POL,5,2,11,18
706,1972,Summer,Poland,POL,7,5,9,21
707,1976,Summer,Poland,POL,7,6,13,26
708,1980,Summer,Poland,POL,3,14,15,32
709,1988,Summer,Poland,POL,2,5,9,16
710,1992,Summer,Poland,POL,3,6,10,19
711,1996,Summer,Poland,POL,7,5,5,17
712,2000,Summer,Poland,POL,6,5,3,14
713,2004,Summer,Poland,POL,3,2,5,10
714,2008,Summer,Poland,POL,4,5,2,11
715,2012,Summer,Poland,POL,3,2,6,11
716,2016,Summer,Poland,POL,2,3,6,11
717,1960,Summer,Poland,POL,4,6,11,21
718,2020,Summer,Poland,POL,4,5,5,14
719,1976,Summer,Portugal,POR,0,2,0,2
720,1984,Summer,Portugal,POR,1,0,2,3
721,1988,Summer,Portugal,POR,1,0,0,1
722,1996,Summer,Portugal,POR,1,0,1,2
723,2000,Summer,Portugal,POR,0,0,2,2
724,2004,Summer,Portugal,POR,0,2,1,3
725,2008,Summer,Portugal,POR,1,1,0,2
726,2012,Summer,Portugal,POR,0,1,0,1
727,2016,Summer,Portugal,POR,0,0,1,1
728,1960,Summer,Portugal,POR,0,1,0,1
729,2020,Summer,Portugal,POR,1,1,2,4
730,1976,Summer,Puerto Rico,PUR,0,0,1,1
731,1984,Summer,Puerto Rico,PUR,0,1,1,2
732,1992,Summer,Puerto Rico,PUR,0,0,1,1
733,1996,Summer,Puerto Rico,PUR,0,0,1,1
734,2012,Summer,Puerto Rico,PUR,0,1,1,2
735,2016,Summer,Puerto Rico,PUR,1,0,0,1
736,2020,Summer,Puerto Rico,PUR,1,0,0,1
737,1992,Summer,Qatar,QAT,0,0,1,1
738,2000,Summer,Qatar,QAT,0,0,1,1
739,2012,Summer,Qatar,QAT,0,1,1,2
740,2016,Summer,Qatar,QAT,0,1,0,1
741,2020,Summer,Qatar,QAT,2,0,1,3
742,2020,Summer,ROC ,ROC,20,28,23,71
743,1964,Summer,Romania,ROU,2,4,6,12
744,1968,Summer,Romania,ROU,4,6,5,15
745,1972,Summer,Romania,ROU,3,6,7,16
746,1976,Summer,Romania,ROU,4,9,14,27
747,1980,Summer,Romania,ROU,6,6,13,25
748,1984,Summer,Romania,ROU,20,16,17,53
749,1988,Summer,Romania,ROU,7,11,6,24
750,1992,Summer,Romania,ROU,4,6,8,18
751,1996,Summer,Romania,ROU,4,7,9,20
752,2000,Summer,Romania,ROU,11,6,9,26
753,2004,Summer,Romania,ROU,8,5,6,19
754,2008,Summer,Romania,ROU,4,1,4,9
755,2012,Summer,Romania,ROU,2,4,1,7
756,2016,Summer,Romania,ROU,1,1,2,4
757,1960,Summer,Romania,ROU,3,1,6,10
758,2020,Summer,Romania,ROU,1,3,0,4
759,1996,Summer,Russia,RUS,26,21,16,63
760,2000,Summer,Russia,RUS,32,28,29,89
761,2004,Summer,Russia,RUS,28,26,36,90
762,2008,Summer,Russia,RUS,24,13,23,60
763,2012,Summer,Russia,RUS,20,21,27,68
764,2016,Summer,Russia,RUS,19,17,20,56
765,2008,Summer,Samoa,SAM,0,1,0,1
766,2020,Summer,San Marino ,SMR,0,1,2,3
767,2000,Summer,Saudi Arabia,KSA,0,1,1,2
768,2012,Summer,Saudi Arabia,KSA,0,0,1,1
769,2020,Summer,Saudi Arabia,KSA,0,1,0,1
770,1988,Summer,Senegal,SEN,0,1,0,1
771,2008,Summer,Serbia,SRB,0,1,2,3
772,2012,Summer,Serbia,SRB,1,1,2,4
773,2016,Summer,Serbia,SRB,2,4,2,8
774,2004,Summer,Serbia and Montenegro,SCG,0,2,0,2
775,2020,Summer,Serbia,SRB,3,1,5,9
776,2008,Summer,Singapore,SGP,0,1,0,1
777,2012,Summer,Singapore,SGP,0,0,2,2
778,2016,Summer,Singapore,SGP,1,0,0,1
779,1960,Summer,Singapore,SGP,0,1,0,1
780,1996,Summer,Slovakia,SVK,1,1,1,3
781,2000,Summer,Slovakia,SVK,1,3,1,5
782,2004,Summer,Slovakia,SVK,2,2,2,6
783,2008,Summer,Slovakia,SVK,3,3,0,6
784,2012,Summer,Slovakia,SVK,0,1,3,4
785,2016,Summer,Slovakia,SVK,2,2,0,4
786,2020,Summer,Slovakia,SVK,1,2,1,4
787,1992,Summer,Slovenia,SLO,0,0,2,2
788,1996,Summer,Slovenia,SLO,0,2,0,2
789,2000,Summer,Slovenia,SLO,2,0,0,2
790,2004,Summer,Slovenia,SLO,0,1,3,4
791,2008,Summer,Slovenia,SLO,1,2,2,5
792,2012,Summer,Slovenia,SLO,1,1,2,4
793,2016,Summer,Slovenia,SLO,1,2,1,4
794,2020,Summer,Slovenia,SLO,3,1,1,5
795,1992,Summer,South Africa,RSA,0,2,0,2
796,1996,Summer,South Africa,RSA,3,1,1,5
797,2000,Summer,South Africa,RSA,0,2,3,5
798,2004,Summer,South Africa,RSA,1,3,2,6
799,2008,Summer,South Africa,RSA,0,1,0,1
800,2012,Summer,South Africa,RSA,4,1,1,6
801,2016,Summer,South Africa,RSA,2,6,2,10
802,1960,Summer,South Africa,RSA,0,1,2,3
803,2020,Summer,South Africa,RSA,1,2,0,3
804,1964,Summer,South Korea,KOR,0,2,1,3
805,1968,Summer,South Korea,KOR,0,1,1,2
806,1972,Summer,South Korea,KOR,0,1,0,1
807,1976,Summer,South Korea,KOR,1,1,4,6
808,1984,Summer,South Korea,KOR,6,6,7,19
809,1992,Summer,South Korea,KOR,12,5,12,29
810,1996,Summer,South Korea,KOR,7,15,5,27
811,2000,Summer,South Korea,KOR,8,10,10,28
812,2004,Summer,South Korea,KOR,9,12,9,30
813,2008,Summer,South Korea,KOR,13,11,8,32
814,2012,Summer,South Korea,KOR,13,9,8,30
815,2016,Summer,South Korea,KOR,9,3,9,21
816,2020,Summer,South Korea,KOR,6,4,10,20
817,1988,Summer,South Korea*,KOR,12,10,11,33
818,1964,Summer,Soviet Union,"SOV (1968 W)
code from French Union des républiques socialistes soviétiques (URSS)",30,31,35,96
819,1968,Summer,Soviet Union,"SOV (1968 W)
code from French Union des républiques socialistes soviétiques (URSS)",29,32,30,91
820,1972,Summer,Soviet Union,"SOV (1968 W)
code from French Union des républiques socialistes soviétiques (URSS)",50,27,22,99
821,1976,Summer,Soviet Union,"SOV (1968 W)
code from French Union des républiques socialistes soviétiques (URSS)",49,41,35,125
822,1988,Summer,Soviet Union,"SOV (1968 W)
code from French Union des républiques socialistes soviétiques (URSS)",55,31,46,132
823,1960,Summer,Soviet Union,"SOV (1968 W)
code from French Union des républiques socialistes soviétiques (URSS)",43,29,31,103
824,1980,Summer,Soviet Union*,"SOV (1968 W)
code from French Union des républiques socialistes soviétiques (URSS)",80,69,46,195
825,1972,Summer,Spain,ESP,0,0,1,1
826,1976,Summer,Spain,ESP,0,2,0,2
827,1980,Summer,Spain,ESP,1,3,2,6
828,1984,Summer,Spain,ESP,1,2,2,5
829,1988,Summer,Spain,ESP,1,1,2,4
830,1996,Summer,Spain,ESP,5,6,6,17
831,2000,Summer,Spain,ESP,3,3,5,11
832,2004,Summer,Spain,ESP,3,11,6,20
833,2008,Summer,Spain,ESP,5,11,3,19
834,2012,Summer,Spain,ESP,4,10,6,20
835,2016,Summer,Spain,ESP,7,4,6,17
836,1960,Summer,Spain,ESP,0,0,1,1
837,2020,Summer,Spain,ESP,3,8,6,17
838,1992,Summer,Spain*,ESP,13,7,2,22
839,2000,Summer,Sri Lanka,SRI,0,1,0,1
840,2008,Summer,Sudan,SUD,0,1,0,1
841,1988,Summer,Suriname,SUR,1,0,0,1
842,1992,Summer,Suriname,SUR,0,0,1,1
843,1964,Summer,Sweden,SWE,2,2,4,8
844,1968,Summer,Sweden,SWE,2,1,1,4
845,1972,Summer,Sweden,SWE,4,6,6,16
846,1976,Summer,Sweden,SWE,4,1,0,5
847,1980,Summer,Sweden,SWE,3,3,6,12
848,1984,Summer,Sweden,SWE,2,11,6,19
849,1988,Summer,Sweden,SWE,0,4,7,11
850,1992,Summer,Sweden,SWE,1,7,4,12
851,1996,Summer,Sweden,SWE,2,4,2,8
852,2000,Summer,Sweden,SWE,4,5,3,12
853,2004,Summer,Sweden,SWE,4,2,1,7
854,2008,Summer,Sweden,SWE,0,4,1,5
855,2012,Summer,Sweden,SWE,1,4,3,8
856,2016,Summer,Sweden,SWE,2,6,3,11
857,1960,Summer,Sweden,SWE,1,2,3,6
858,2020,Summer,Sweden,SWE,3,6,0,9
859,1964,Summer,Switzerland,SUI,1,2,1,4
860,1968,Summer,Switzerland,SUI,0,1,4,5
861,1972,Summer,Switzerland,SUI,0,3,0,3
862,1976,Summer,Switzerland,SUI,1,1,2,4
863,1980,Summer,Switzerland,SUI,2,0,0,2
864,1984,Summer,Switzerland,SUI,0,4,4,8
865,1988,Summer,Switzerland,SUI,0,2,2,4
866,1992,Summer,Switzerland,SUI,1,0,0,1
867,1996,Summer,Switzerland,SUI,4,3,0,7
868,2000,Summer,Switzerland,SUI,1,6,2,9
869,2004,Summer,Switzerland,SUI,1,1,3,5
870,2008,Summer,Switzerland,SUI,2,1,4,7
871,2012,Summer,Switzerland,SUI,2,2,0,4
872,2016,Summer,Switzerland,SUI,3,2,2,7
873,1960,Summer,Switzerland,SUI,0,3,3,6
874,2020,Summer,Switzerland,SUI,3,4,6,13
875,1984,Summer,Syria,SYR,0,1,0,1
876,1996,Summer,Syria,SYR,1,0,0,1
877,2004,Summer,Syria,SYR,0,0,1,1
878,2020,Summer,Syria,SYR,0,0,1,1
879,1968,Summer,Taiwan,TWN,0,0,1,1
880,2008,Summer,Tajikistan,TJK,0,1,1,2
881,2012,Summer,Tajikistan,TJK,0,0,1,1
882,2016,Summer,Tajikistan,TJK,1,0,0,1
883,1980,Summer,Tanzania,TAN,0,2,0,2
884,1976,Summer,Thailand,THA,0,0,1,1
885,1984,Summer,Thailand,THA,0,1,0,1
886,1988,Summer,Thailand,THA,0,0,1,1
887,1992,Summer,Thailand,THA,0,0,1,1
888,1996,Summer,Thailand,THA,1,0,1,2
889,2000,Summer,Thailand,THA,1,0,2,3
890,2004,Summer,Thailand,THA,3,1,4,8
891,2008,Summer,Thailand,THA,2,2,2,6
892,2012,Summer,Thailand,THA,0,2,2,4
893,2016,Summer,Thailand,THA,2,2,2,6
894,2020,Summer,Thailand,THA,1,0,1,2
895,2008,Summer,Togo,TOG,0,0,1,1
896,1996,Summer,Tonga,TGA,0,1,0,1
897,1964,Summer,Trinidad and Tobago,TTO,0,1,2,3
898,1976,Summer,Trinidad and Tobago,TTO,1,0,0,1
899,1996,Summer,Trinidad and Tobago,TTO,0,0,2,2
900,2000,Summer,Trinidad and Tobago,TTO,0,1,1,2
901,2004,Summer,Trinidad and Tobago,TTO,0,0,1,1
902,2008,Summer,Trinidad and Tobago,TTO,1,1,0,2
903,2012,Summer,Trinidad and Tobago,TTO,1,1,2,4
904,2016,Summer,Trinidad and Tobago,TTO,0,0,1,1
905,1964,Summer,Tunisia,TUN,0,1,1,2
906,1968,Summer,Tunisia,TUN,1,0,1,2
907,1972,Summer,Tunisia,TUN,0,1,0,1
908,1996,Summer,Tunisia,TUN,0,0,1,1
909,2008,Summer,Tunisia,TUN,1,0,0,1
910,2012,Summer,Tunisia,TUN,2,0,1,3
911,2016,Summer,Tunisia,TUN,0,0,3,3
912,2020,Summer,Tunisia,TUN,1,1,0,2
913,1964,Summer,Turkey,TUR,2,3,1,6
914,1968,Summer,Turkey,TUR,2,0,0,2
915,1972,Summer,Turkey,TUR,0,1,0,1
916,1984,Summer,Turkey,TUR,0,0,3,3
917,1988,Summer,Turkey,TUR,1,1,0,2
918,1992,Summer,Turkey,TUR,2,2,2,6
919,1996,Summer,Turkey,TUR,4,1,1,6
920,2000,Summer,Turkey,TUR,3,0,2,5
921,2004,Summer,Turkey,TUR,3,3,5,11
922,2008,Summer,Turkey,TUR,1,1,3,5
923,2012,Summer,Turkey,TUR,1,1,1,3
924,2016,Summer,Turkey,TUR,1,3,4,8
925,1960,Summer,Turkey,TUR,7,2,0,9
926,2020,Summer,Turkey,TUR,2,2,9,13
927,2020,Summer,Turkmenistan ,TKM,0,1,0,1
928,1968,Summer,Uganda,UGA,0,1,1,2
929,1972,Summer,Uganda,UGA,1,1,0,2
930,1980,Summer,Uganda,UGA,0,1,0,1
931,1996,Summer,Uganda,UGA,0,0,1,1
932,2012,Summer,Uganda,UGA,1,0,0,1
933,2020,Summer,Uganda,UGA,2,1,1,4
934,1996,Summer,Ukraine,UKR,9,2,12,23
935,2000,Summer,Ukraine,UKR,3,10,10,23
936,2004,Summer,Ukraine,UKR,8,5,9,22
937,2008,Summer,Ukraine,UKR,7,4,11,22
938,2012,Summer,Ukraine,UKR,5,4,10,19
939,2016,Summer,Ukraine,UKR,2,5,4,11
940,2020,Summer,Ukraine,UKR,1,6,12,19
941,1992,Summer,Unified Team,EUN,45,38,29,112
942,2004,Summer,United Arab Emirates,UAE,1,0,0,1
943,2016,Summer,United Arab Emirates,UAE,0,0,1,1
944,1964,Summer,United States,USA,36,26,28,90
945,1968,Summer,United States,USA,45,28,34,107
946,1972,Summer,United States,USA,33,31,30,94
947,1976,Summer,United States,USA,34,35,25,94
948,1988,Summer,United States,USA,36,31,27,94
949,1992,Summer,United States,USA,37,34,37,108
950,2000,Summer,United States,USA,37,24,32,93
951,2004,Summer,United States,USA,36,39,26,101
952,2008,Summer,United States,USA,36,39,37,112
953,2012,Summer,United States,USA,47,27,30,104
954,2016,Summer,United States,USA,46,37,38,121
955,1960,Summer,United States,USA,34,21,16,71
956,2020,Summer,United States,USA,39,41,33,113
957,1984,Summer,United States*,USA,83,61,30,174
958,1996,Summer,United States*,USA,44,32,25,101
959,1964,Summer,United Team of Germany,EUA,10,22,18,50
960,1960,Summer,United Team of Germany ,EUA,12,19,11,42
961,1964,Summer,Uruguay,URU,0,0,1,1
962,2000,Summer,Uruguay,URU,0,1,0,1
963,1996,Summer,Uzbekistan,UZB,0,1,1,2
964,2000,Summer,Uzbekistan,UZB,1,1,2,4
965,2004,Summer,Uzbekistan,UZB,2,1,2,5
966,2008,Summer,Uzbekistan,UZB,0,1,3,4
967,2012,Summer,Uzbekistan,UZB,0,0,3,3
968,2016,Summer,Uzbekistan,UZB,4,2,7,13
969,2020,Summer,Uzbekistan,UZB,3,0,2,5
970,1968,Summer,Venezuela,VEN,1,0,0,1
971,1976,Summer,Venezuela,VEN,0,1,0,1
972,1980,Summer,Venezuela,VEN,0,1,0,1
973,1984,Summer,Venezuela,VEN,0,0,3,3
974,2004,Summer,Venezuela,VEN,0,0,2,2
975,2008,Summer,Venezuela,VEN,0,0,1,1
976,2012,Summer,Venezuela,VEN,1,0,0,1
977,2016,Summer,Venezuela,VEN,0,2,1,3
978,1960,Summer,Venezuela,VEN,0,0,1,1
979,2020,Summer,Venezuela,VEN,1,3,0,4
980,2000,Summer,Vietnam,VIE,0,1,0,1
981,2008,Summer,Vietnam,VIE,0,1,0,1
982,2012,Summer,Vietnam,VIE,0,0,1,1
983,2016,Summer,Vietnam,VIE,1,1,0,2
984,1988,Summer,Virgin Islands,ISV,0,1,0,1
985,1968,Summer,West Germany,FRG,5,11,10,26
986,1976,Summer,West Germany,FRG,10,12,17,39
987,1984,Summer,West Germany,FRG,17,19,23,59
988,1988,Summer,West Germany,FRG,11,14,15,40
989,1972,Summer,West Germany*,FRG,13,11,16,40
990,1964,Summer,Yugoslavia,YUG,2,1,2,5
991,1968,Summer,Yugoslavia,YUG,3,3,2,8
992,1972,Summer,Yugoslavia,YUG,2,1,2,5
993,1976,Summer,Yugoslavia,YUG,2,3,3,8
994,1980,Summer,Yugoslavia,YUG,2,3,4,9
995,1984,Summer,Yugoslavia,YUG,7,4,7,18
996,1988,Summer,Yugoslavia,YUG,3,4,5,12
997,1960,Summer,Yugoslavia ,YUG,1,1,0,2
998,1984,Summer,Zambia,ZAM,0,0,1,1
999,1996,Summer,Zambia,ZAM,0,1,0,1
1000,1980,Summer,Zimbabwe,ZIM,1,0,0,1
1001,2004,Summer,Zimbabwe,ZIM,1,1,1,3
1002,2008,Summer,Zimbabwe,ZIM,1,3,0,4
1003,1960,Winter,Austria,AUT,1,2,3,6
1004,1960,Winter,Canada,CAN,2,1,1,4
1005,1960,Winter,Czechoslovakia,TCH,0,1,0,1
1006,1960,Winter,Finland,FIN,2,3,3,8
1007,1960,Winter,France,FRA,1,0,2,3
1008,1960,Winter,Italy,ITA,0,0,1,1
1009,1960,Winter,Netherlands,NED,0,1,1,2
1010,1960,Winter,Norway,NOR,3,3,0,6
1011,1960,Winter,Poland,POL,0,1,1,2
1012,1960,Winter,Soviet Union,URS,7,5,9,21
1013,1960,Winter,Sweden,SWE,3,2,2,7
1014,1960,Winter,Switzerland,SUI,2,0,0,2
1015,1960,Winter,United States*,USA,3,4,3,10
1016,1960,Winter,United Team of Germany,EUA,4,3,1,8
1017,1964,Winter,Austria*,AUT,4,5,3,12
1018,1964,Winter,Canada,CAN,1,1,1,3
1019,1964,Winter,Czechoslovakia,TCH,0,0,1,1
1020,1964,Winter,Finland,FIN,3,4,3,10
1021,1964,Winter,France,FRA,3,4,0,7
1022,1964,Winter,Great Britain,GBR,1,0,0,1
1023,1964,Winter,Italy,ITA,0,1,3,4
1024,1964,Winter,Netherlands,NED,1,1,0,2
1025,1964,Winter,North Korea,PRK,0,1,0,1
1026,1964,Winter,Norway,NOR,3,6,6,15
1027,1964,Winter,Soviet Union,URS,11,8,6,25
1028,1964,Winter,Sweden,SWE,3,3,1,7
1029,1964,Winter,United States,USA,1,2,4,7
1030,1964,Winter,United Team of Germany,EUA,3,3,3,9
1031,1968,Winter,Austria,AUT,3,4,4,11
1032,1968,Winter,Canada,CAN,1,1,1,3
1033,1968,Winter,Czechoslovakia,TCH,1,2,1,4
1034,1968,Winter,East Germany,GDR,1,2,2,5
1035,1968,Winter,Finland,FIN,1,2,2,5
1036,1968,Winter,France*,FRA,4,3,2,9
1037,1968,Winter,Italy,ITA,4,0,0,4
1038,1968,Winter,Netherlands,NED,3,3,3,9
1039,1968,Winter,Norway,NOR,6,6,2,14
1040,1968,Winter,Romania,ROU,0,0,1,1
1041,1968,Winter,Soviet Union,URS,5,5,3,13
1042,1968,Winter,Sweden,SWE,3,2,3,8
1043,1968,Winter,Switzerland,SUI,0,2,4,6
1044,1968,Winter,United States,USA,1,5,1,7
1045,1968,Winter,West Germany,FRG,2,2,3,7
1046,1972,Winter,Austria,AUT,1,2,2,5
1047,1972,Winter,Canada,CAN,0,1,0,1
1048,1972,Winter,Czechoslovakia,TCH,1,0,2,3
1049,1972,Winter,East Germany,GDR,4,3,7,14
1050,1972,Winter,Finland,FIN,0,4,1,5
1051,1972,Winter,France,FRA,0,1,2,3
1052,1972,Winter,Italy,ITA,2,2,1,5
1053,1972,Winter,Japan*,JPN,1,1,1,3
1054,1972,Winter,Netherlands,NED,4,3,2,9
1055,1972,Winter,Norway,NOR,2,5,5,12
1056,1972,Winter,Poland,POL,1,0,0,1
1057,1972,Winter,Soviet Union,URS,8,5,3,16
1058,1972,Winter,Spain,ESP,1,0,0,1
1059,1972,Winter,Sweden,SWE,1,1,2,4
1060,1972,Winter,Switzerland,SUI,4,3,3,10
1061,1972,Winter,United States,USA,3,2,3,8
1062,1972,Winter,West Germany,FRG,3,1,1,5
1063,1976,Winter,Austria*,AUT,2,2,2,6
1064,1976,Winter,Canada,CAN,1,1,1,3
1065,1976,Winter,Czechoslovakia,TCH,0,1,0,1
1066,1976,Winter,East Germany,GDR,7,5,7,19
1067,1976,Winter,Finland,FIN,2,4,1,7
1068,1976,Winter,France,FRA,0,0,1,1
1069,1976,Winter,Great Britain,GBR,1,0,0,1
1070,1976,Winter,Italy,ITA,1,2,1,4
1071,1976,Winter,Liechtenstein,LIE,0,0,2,2
1072,1976,Winter,Netherlands,NED,1,2,3,6
1073,1976,Winter,Norway,NOR,3,3,1,7
1074,1976,Winter,Soviet Union,URS,13,6,8,27
1075,1976,Winter,Sweden,SWE,0,0,2,2
1076,1976,Winter,Switzerland,SUI,1,3,1,5
1077,1976,Winter,United States,USA,3,3,4,10
1078,1976,Winter,West Germany,FRG,2,5,3,10
1079,1980,Winter,Austria,AUT,3,2,2,7
1080,1980,Winter,Bulgaria,BUL,0,0,1,1
1081,1980,Winter,Canada,CAN,0,1,1,2
1082,1980,Winter,Czechoslovakia,TCH,0,0,1,1
1083,1980,Winter,East Germany,GDR,9,7,7,23
1084,1980,Winter,Finland,FIN,1,5,3,9
1085,1980,Winter,France,FRA,0,0,1,1
1086,1980,Winter,Great Britain,GBR,1,0,0,1
1087,1980,Winter,Hungary,HUN,0,1,0,1
1088,1980,Winter,Italy,ITA,0,2,0,2
1089,1980,Winter,Japan,JPN,0,1,0,1
1090,1980,Winter,Liechtenstein,LIE,2,2,0,4
1091,1980,Winter,Netherlands,NED,1,2,1,4
1092,1980,Winter,Norway,NOR,1,3,6,10
1093,1980,Winter,Soviet Union,URS,10,6,6,22
1094,1980,Winter,Sweden,SWE,3,0,1,4
1095,1980,Winter,Switzerland,SUI,1,1,3,5
1096,1980,Winter,United States*,USA,6,4,2,12
1097,1980,Winter,West Germany,FRG,0,2,3,5
1098,1984,Winter,Austria,AUT,0,0,1,1
1099,1984,Winter,Canada,CAN,2,1,1,4
1100,1984,Winter,Czechoslovakia,TCH,0,2,4,6
1101,1984,Winter,East Germany,GDR,9,9,6,24
1102,1984,Winter,Finland,FIN,4,3,6,13
1103,1984,Winter,France,FRA,0,1,2,3
1104,1984,Winter,Great Britain,GBR,1,0,0,1
1105,1984,Winter,Italy,ITA,2,0,0,2
1106,1984,Winter,Japan,JPN,0,1,0,1
1107,1984,Winter,Liechtenstein,LIE,0,0,2,2
1108,1984,Winter,Norway,NOR,3,2,4,9
1109,1984,Winter,Soviet Union,URS,6,10,9,25
1110,1984,Winter,Sweden,SWE,4,2,2,8
1111,1984,Winter,Switzerland,SUI,2,2,1,5
1112,1984,Winter,United States,USA,4,4,0,8
1113,1984,Winter,West Germany,FRG,2,1,1,4
1114,1984,Winter,Yugoslavia*,YUG,0,1,0,1
1115,1988,Winter,Austria,AUT,3,5,2,10
1116,1988,Winter,Canada*,CAN,0,2,3,5
1117,1988,Winter,Czechoslovakia,TCH,0,1,2,3
1118,1988,Winter,East Germany,GDR,9,10,6,25
1119,1988,Winter,Finland,FIN,4,1,2,7
1120,1988,Winter,France,FRA,1,0,1,2
1121,1988,Winter,Italy,ITA,2,1,2,5
1122,1988,Winter,Japan,JPN,0,0,1,1
1123,1988,Winter,Liechtenstein,LIE,0,0,1,1
1124,1988,Winter,Netherlands,NED,3,2,2,7
1125,1988,Winter,Norway,NOR,0,3,2,5
1126,1988,Winter,Soviet Union,URS,11,9,9,29
1127,1988,Winter,Sweden,SWE,4,0,2,6
1128,1988,Winter,Switzerland,SUI,5,5,5,15
1129,1988,Winter,United States,USA,2,1,3,6
1130,1988,Winter,West Germany,FRG,2,4,2,8
1131,1988,Winter,Yugoslavia,YUG,0,2,1,3
1132,1992,Winter,Austria,AUT,6,7,8,21
1133,1992,Winter,Canada,CAN,2,3,2,7
1134,1992,Winter,China,CHN,0,3,0,3
1135,1992,Winter,Czechoslovakia,TCH,0,0,3,3
1136,1992,Winter,Finland,FIN,3,1,3,7
1137,1992,Winter,France*,FRA,3,5,1,9
1138,1992,Winter,Germany,GER,10,10,6,26
1139,1992,Winter,Italy,ITA,4,6,4,14
1140,1992,Winter,Japan,JPN,1,2,4,7
1141,1992,Winter,Luxembourg,LUX,0,2,0,2
1142,1992,Winter,Netherlands,NED,1,1,2,4
1143,1992,Winter,New Zealand,NZL,0,1,0,1
1144,1992,Winter,North Korea,PRK,0,0,1,1
1145,1992,Winter,Norway,NOR,9,6,5,20
1146,1992,Winter,South Korea,KOR,2,1,1,4
1147,1992,Winter,Spain,ESP,0,0,1,1
1148,1992,Winter,Sweden,SWE,1,0,3,4
1149,1992,Winter,Switzerland,SUI,1,0,2,3
1150,1992,Winter,Unified Team,EUN,9,6,8,23
1151,1992,Winter,United States,USA,5,4,2,11
1152,1994,Winter,Australia,AUS,0,0,1,1
1153,1994,Winter,Austria,AUT,2,3,4,9
1154,1994,Winter,Belarus,BLR,0,2,0,2
1155,1994,Winter,Canada,CAN,3,6,4,13
1156,1994,Winter,China,CHN,0,1,2,3
1157,1994,Winter,Finland,FIN,0,1,5,6
1158,1994,Winter,France,FRA,0,1,4,5
1159,1994,Winter,Germany,GER,9,7,8,24
1160,1994,Winter,Great Britain,GBR,0,0,2,2
1161,1994,Winter,Italy,ITA,7,5,8,20
1162,1994,Winter,Japan,JPN,1,2,2,5
1163,1994,Winter,Kazakhstan,KAZ,1,2,0,3
1164,1994,Winter,Netherlands,NED,0,1,3,4
1165,1994,Winter,Norway*,NOR,10,11,5,26
1166,1994,Winter,Russia,RUS,11,8,4,23
1167,1994,Winter,Slovenia,SLO,0,0,3,3
1168,1994,Winter,South Korea,KOR,4,1,1,6
1169,1994,Winter,Sweden,SWE,2,1,0,3
1170,1994,Winter,Switzerland,SUI,3,4,2,9
1171,1994,Winter,Ukraine,UKR,1,0,1,2
1172,1994,Winter,United States,USA,6,5,2,13
1173,1994,Winter,Uzbekistan,UZB,1,0,0,1
1174,1998,Winter,Australia,AUS,0,0,1,1
1175,1998,Winter,Austria,AUT,3,5,9,17
1176,1998,Winter,Belarus,BLR,0,0,2,2
1177,1998,Winter,Belgium,BEL,0,0,1,1
1178,1998,Winter,Bulgaria,BUL,1,0,0,1
1179,1998,Winter,Canada,CAN,6,5,4,15
1180,1998,Winter,China,CHN,0,6,2,8
1181,1998,Winter,Czech Republic,CZE,1,1,1,3
1182,1998,Winter,Denmark,DEN,0,1,0,1
1183,1998,Winter,Finland,FIN,2,4,6,12
1184,1998,Winter,France,FRA,2,1,5,8
1185,1998,Winter,Germany,GER,12,9,8,29
1186,1998,Winter,Great Britain,GBR,0,0,1,1
1187,1998,Winter,Italy,ITA,2,6,2,10
1188,1998,Winter,Japan*,JPN,5,1,4,10
1189,1998,Winter,Kazakhstan,KAZ,0,0,2,2
1190,1998,Winter,Netherlands,NED,5,4,2,11
1191,1998,Winter,Norway,NOR,10,10,5,25
1192,1998,Winter,Russia,RUS,9,6,3,18
1193,1998,Winter,South Korea,KOR,3,1,2,6
1194,1998,Winter,Sweden,SWE,0,2,1,3
1195,1998,Winter,Switzerland,SUI,2,2,3,7
1196,1998,Winter,Ukraine,UKR,0,1,0,1
1197,1998,Winter,United States,USA,6,3,4,13
1198,2002,Winter,Australia,AUS,2,0,0,2
1199,2002,Winter,Austria,AUT,3,4,10,17
1200,2002,Winter,Belarus,BLR,0,0,1,1
1201,2002,Winter,Bulgaria,BUL,0,1,2,3
1202,2002,Winter,Canada,CAN,7,3,7,17
1203,2002,Winter,China,CHN,2,2,4,8
1204,2002,Winter,Croatia,CRO,3,1,0,4
1205,2002,Winter,Czech Republic,CZE,1,2,0,3
1206,2002,Winter,Estonia,EST,1,1,1,3
1207,2002,Winter,Finland,FIN,4,2,1,7
1208,2002,Winter,France,FRA,4,5,2,11
1209,2002,Winter,Germany,GER,12,16,8,36
1210,2002,Winter,Great Britain,GBR,1,0,1,2
1211,2002,Winter,Italy,ITA,4,4,5,13
1212,2002,Winter,Japan,JPN,0,1,1,2
1213,2002,Winter,Netherlands,NED,3,5,0,8
1214,2002,Winter,Norway,NOR,13,5,7,25
1215,2002,Winter,Poland,POL,0,1,1,2
1216,2002,Winter,Russia,RUS,5,4,4,13
1217,2002,Winter,Slovenia,SLO,0,0,1,1
1218,2002,Winter,South Korea,KOR,2,2,0,4
1219,2002,Winter,Sweden,SWE,0,2,5,7
1220,2002,Winter,Switzerland,SUI,3,2,6,11
1221,2002,Winter,United States*,USA,10,13,11,34
1222,2006,Winter,Australia,AUS,1,0,1,2
1223,2006,Winter,Austria,AUT,9,7,7,23
1224,2006,Winter,Belarus,BLR,0,1,0,1
1225,2006,Winter,Bulgaria,BUL,0,1,0,1
1226,2006,Winter,Canada,CAN,7,10,7,24
1227,2006,Winter,China,CHN,2,4,5,11
1228,2006,Winter,Croatia,CRO,1,2,0,3
1229,2006,Winter,Czech Republic,CZE,1,2,1,4
1230,2006,Winter,Estonia,EST,3,0,0,3
1231,2006,Winter,Finland,FIN,0,6,3,9
1232,2006,Winter,France,FRA,3,2,4,9
1233,2006,Winter,Germany,GER,11,12,6,29
1234,2006,Winter,Great Britain,GBR,0,1,0,1
1235,2006,Winter,Italy*,ITA,5,0,6,11
1236,2006,Winter,Japan,JPN,1,0,0,1
1237,2006,Winter,Latvia,LAT,0,0,1,1
1238,2006,Winter,Netherlands,NED,3,2,4,9
1239,2006,Winter,Norway,NOR,2,8,9,19
1240,2006,Winter,Poland,POL,0,1,1,2
1241,2006,Winter,Russia,RUS,8,6,8,22
1242,2006,Winter,Slovakia,SVK,0,1,0,1
1243,2006,Winter,South Korea,KOR,6,3,2,11
1244,2006,Winter,Sweden,SWE,7,2,5,14
1245,2006,Winter,Switzerland,SUI,5,4,5,14
1246,2006,Winter,Ukraine,UKR,0,0,2,2
1247,2006,Winter,United States,USA,9,9,7,25
1248,2010,Winter,Australia,AUS,2,1,0,3
1249,2010,Winter,Austria,AUT,4,6,6,16
1250,2010,Winter,Belarus,BLR,1,1,1,3
1251,2010,Winter,Canada*,CAN,14,7,5,26
1252,2010,Winter,China,CHN,5,2,4,11
1253,2010,Winter,Croatia,CRO,0,2,1,3
1254,2010,Winter,Czech Republic,CZE,2,0,4,6
1255,2010,Winter,Estonia,EST,0,1,0,1
1256,2010,Winter,Finland,FIN,0,1,4,5
1257,2010,Winter,France,FRA,2,3,6,11
1258,2010,Winter,Germany,GER,10,13,7,30
1259,2010,Winter,Great Britain,GBR,1,0,0,1
1260,2010,Winter,Italy,ITA,1,1,3,5
1261,2010,Winter,Japan,JPN,0,3,2,5
1262,2010,Winter,Kazakhstan,KAZ,0,1,0,1
1263,2010,Winter,Latvia,LAT,0,2,0,2
1264,2010,Winter,Netherlands,NED,4,1,3,8
1265,2010,Winter,Norway,NOR,9,8,6,23
1266,2010,Winter,Poland,POL,1,3,2,6
1267,2010,Winter,Russia,RUS,3,5,7,15
1268,2010,Winter,Slovakia,SVK,1,1,1,3
1269,2010,Winter,Slovenia,SLO,0,2,1,3
1270,2010,Winter,South Korea,KOR,6,6,2,14
1271,2010,Winter,Sweden,SWE,5,2,4,11
1272,2010,Winter,Switzerland,SUI,6,0,3,9
1273,2010,Winter,United States,USA,9,15,13,37
1274,2014,Winter,Australia,AUS,0,2,1,3
1275,2014,Winter,Austria,AUT,4,8,5,17
1276,2014,Winter,Belarus,BLR,5,0,1,6
1277,2014,Winter,Canada,CAN,10,10,5,25
1278,2014,Winter,China,CHN,3,4,2,9
1279,2014,Winter,Croatia,CRO,0,1,0,1
1280,2014,Winter,Czech Republic,CZE,2,4,2,8
1281,2014,Winter,Finland,FIN,1,3,1,5
1282,2014,Winter,France,FRA,4,4,7,15
1283,2014,Winter,Germany,GER,8,6,5,19
1284,2014,Winter,Great Britain,GBR,1,1,3,5
1285,2014,Winter,Italy,ITA,0,2,6,8
1286,2014,Winter,Japan,JPN,1,4,3,8
1287,2014,Winter,Kazakhstan,KAZ,0,0,1,1
1288,2014,Winter,Latvia,LAT,1,1,3,5
1289,2014,Winter,Netherlands,NED,8,7,9,24
1290,2014,Winter,Norway,NOR,11,5,10,26
1291,2014,Winter,Poland,POL,4,1,1,6
1292,2014,Winter,Russia*,RUS,11,10,9,30
1293,2014,Winter,Slovakia,SVK,1,0,0,1
1294,2014,Winter,Slovenia,SLO,2,2,4,8
1295,2014,Winter,South Korea,KOR,3,3,2,8
1296,2014,Winter,Sweden,SWE,2,7,6,15
1297,2014,Winter,Switzerland,SUI,7,2,2,11
1298,2014,Winter,Ukraine,UKR,1,0,1,2
1299,2014,Winter,United States,USA,9,9,10,28
1300,2018,Winter,Australia,AUS,0,2,1,3
1301,2018,Winter,Austria,AUT,5,3,6,14
1302,2018,Winter,Belarus,BLR,2,1,0,3
1303,2018,Winter,Belgium,BEL,0,1,0,1
1304,2018,Winter,Canada,CAN,11,8,10,29
1305,2018,Winter,China,CHN,1,6,2,9
1306,2018,Winter,Czech Republic,CZE,2,2,3,7
1307,2018,Winter,Finland,FIN,1,1,4,6
1308,2018,Winter,France,FRA,5,4,6,15
1309,2018,Winter,Germany,GER,14,10,7,31
1310,2018,Winter,Great Britain,GBR,1,0,4,5
1311,2018,Winter,Hungary,HUN,1,0,0,1
1312,2018,Winter,Italy,ITA,3,2,5,10
1313,2018,Winter,Japan,JPN,4,5,4,13
1314,2018,Winter,Kazakhstan,KAZ,0,0,1,1
1315,2018,Winter,Latvia,LAT,0,0,1,1
1316,2018,Winter,Liechtenstein,LIE,0,0,1,1
1317,2018,Winter,Netherlands,NED,8,6,6,20
1318,2018,Winter,New Zealand,NZL,0,0,2,2
1319,2018,Winter,Norway,NOR,14,14,11,39
1320,2018,Winter,Olympic Athletes from Russia,OAR,2,6,9,17
1321,2018,Winter,Poland,POL,1,0,1,2
1322,2018,Winter,Slovakia,SVK,1,2,0,3
1323,2018,Winter,Slovenia,SLO,0,1,1,2
1324,2018,Winter,South Korea*,KOR,5,8,4,17
1325,2018,Winter,Spain,ESP,0,0,2,2
1326,2018,Winter,Sweden,SWE,7,6,1,14
1327,2018,Winter,Switzerland,SUI,5,6,4,15
1328,2018,Winter,Ukraine,UKR,1,0,0,1
1329,2018,Winter,United States,USA,9,8,6,23
